State,District,Latitude,Longitude,District code,State name,District name,Population,Male,Female,Literate,Male_Literate,Female_Literate,SC,Male_SC,Female_SC,ST,Male_ST,Female_ST,Workers,Male_Workers,Female_Workers,Main_Workers,Marginal_Workers,Non_Workers,Cultivator_Workers,Agricultural_Workers,Household_Workers,Other_Workers,Hindus,Muslims,Christians,Sikhs,Buddhists,Jains,Others_Religions,Religion_Not_Stated,sex_ratio,literacy_rate
Andhra Pradesh,Adilabad,19.284513950073435,78.81321233480176,532,ANDHRA PRADESH,Adilabad,2741239,1369597,1371642,1483347,856350,626997,488596,242844,245752,495794,247472,248322,1323667,748939,574728,1066460,257207,1417572,363737,484912,84661,390357,2399901,275970,15422,1377,25510,617,322,22120,100.0,54.0
Andhra Pradesh,Anantapur,14.312065561843148,77.4601584478577,553,ANDHRA PRADESH,Anantapur,4081148,2064495,2016653,2310960,1338474,972486,583135,292379,290756,154127,78573,75554,2036166,1208544,827622,1679655,356511,2044982,413253,879537,105343,638033,3599372,443456,20463,932,341,1417,309,14858,98.0,57.0
Andhra Pradesh,Chittoor,13.33109263067696,78.92763898886037,554,ANDHRA PRADESH,Chittoor,4174064,2090204,2083860,2667878,1484794,1183084,785760,389582,396178,159165,79756,79409,1933357,1202223,731134,1669852,263505,2240707,434544,748093,57269,693451,3737588,397870,24129,867,253,1322,358,11677,100.0,64.0
Andhra Pradesh,East Godavari,16.782718320784902,82.2432074720511,545,ANDHRA PRADESH,East Godavari,5154296,2569688,2584608,3288577,1716933,1571644,945269,468883,476386,213195,104422,108773,2093681,1545831,547850,1748117,345564,3060615,160407,1122046,57853,753375,4983330,77777,77825,738,413,4149,403,9661,101.0,64.0
Andhra Pradesh,Guntur,15.884925767634847,80.58657614107885,548,ANDHRA PRADESH,Guntur,4887813,2440521,2447292,2960441,1634726,1325715,957407,476333,481074,247089,125105,121984,2381624,1442370,939254,2106326,275298,2506189,302341,1227956,47436,803891,4217597,559770,89763,764,323,3282,332,15982,100.0,61.0
Andhra Pradesh,Hyderabad,17.38971555555556,78.46668888888888,536,ANDHRA PRADESH,Hyderabad,3943323,2018575,1924748,2892155,1542688,1349467,247927,124313,123614,48937,25556,23381,1413297,1045585,367712,1096081,317216,2530026,28308,23029,46157,1315803,2046051,1713405,87522,11446,1268,19560,1929,62142,95.0,73.0
Andhra Pradesh,Karimnagar,18.515483193277312,79.43765428571413,534,ANDHRA PRADESH,Karimnagar,3776269,1880800,1895469,2206829,1257238,949591,709757,352481,357276,106745,53495,53250,1876768,1049463,827305,1590304,286464,1899501,360390,756859,168340,591179,3491139,244723,24979,2086,332,312,115,12583,101.0,58.0
Andhra Pradesh,Khammam,17.683921325051784,80.67008643892335,541,ANDHRA PRADESH,Khammam,2797370,1390988,1406382,1630234,901640,728594,462896,229905,232991,765565,378532,387033,1410062,802906,607156,1215871,194191,1387308,224972,804537,19799,360754,2595321,158887,33463,655,217,459,539,7829,101.0,58.0
Andhra Pradesh,Krishna,16.143872753151673,81.14805061000413,547,ANDHRA PRADESH,Krishna,4517398,2267375,2250023,3009718,1598959,1410759,871063,435412,435651,132464,66734,65730,2048880,1327299,721581,1744978,303902,2468518,150166,1006976,48444,843294,4023678,307043,145598,1393,863,6320,906,31597,99.0,67.0
Andhra Pradesh,Kurnool,15.43759715142429,77.90086836581717,552,ANDHRA PRADESH,Kurnool,4053463,2039227,2014236,2127161,1246369,880792,737945,370215,367730,82831,42052,40779,2029425,1164122,865303,1757520,271905,2024038,310954,1037302,60791,620378,3328380,670737,33165,737,255,2235,434,17520,99.0,52.0
Andhra Pradesh,Mahbubnagar,16.639546224256293,77.98933089244859,538,ANDHRA PRADESH,Mahbubnagar,4053028,2050386,2002642,1940646,1158386,782260,708954,356099,352855,364269,187035,177234,2082501,1140067,942434,1815643,266858,1970527,569142,931084,57846,524429,3673456,334172,21345,658,290,388,267,22452,98.0,48.0
Andhra Pradesh,Medak,17.889304978038055,78.13778901903379,535,ANDHRA PRADESH,Medak,3033288,1523030,1510258,1637137,953406,683731,537947,266413,271534,168985,86574,82411,1442203,837874,604329,1195494,246709,1591085,353221,571129,67642,450211,2637313,342449,34301,1309,554,457,217,16688,99.0,54.0
Andhra Pradesh,Nalgonda,17.113250515463907,79.16984453608244,539,ANDHRA PRADESH,Nalgonda,3488809,1759772,1729037,2001019,1160757,840262,637385,318359,319026,394279,203876,190403,1741693,976428,765265,1493419,248274,1747116,325224,863131,45124,508214,3249231,188646,35025,937,241,250,132,14347,98.0,57.0
Andhra Pradesh,Nizamabad,18.429485849056604,78.07523490566035,533,ANDHRA PRADESH,Nizamabad,2551335,1250641,1300694,1389810,790214,599596,371074,178798,192276,192941,95679,97262,1261076,684320,576756,1055965,205111,1290259,278102,448281,171311,363382,2123426,391596,19653,2357,1847,542,146,11768,104.0,54.0
Andhra Pradesh,Prakasam,15.489039001601704,80.11665790176184,549,ANDHRA PRADESH,Prakasam,3397448,1714764,1682684,1904435,1107686,796749,787861,397242,390619,151145,76677,74468,1700567,991842,708725,1463508,237059,1696881,280029,889218,42603,488717,3150195,220654,18775,266,97,204,206,7051,98.0,56.0
Andhra Pradesh,Srikakulam,18.570900998697432,84.25874814010675,542,ANDHRA PRADESH,Srikakulam,2703114,1341738,1361376,1495381,857824,637557,255664,125214,130450,166118,81382,84736,1290288,766483,523805,936244,354044,1412826,165317,700833,34479,389659,2666950,9025,18879,193,77,160,106,7724,101.0,55.0
Andhra Pradesh,Vizianagaram,18.28329696032972,83.45982854198873,543,ANDHRA PRADESH,Vizianagaram,2344474,1161477,1182997,1238388,707503,530885,247728,121493,126235,235556,114687,120869,1157962,679289,478673,953215,204747,1186512,212285,557254,27469,360954,2299129,16423,17853,380,114,815,183,9577,102.0,53.0
Andhra Pradesh,Warangal,18.01752608695651,79.87422028985509,540,ANDHRA PRADESH,Warangal,3512576,1759281,1753295,2065023,1179790,885233,616102,307709,308393,530656,268976,261680,1705655,960926,744729,1442197,263458,1806921,401646,758092,43550,502367,3273755,197333,31377,1453,253,569,126,7710,100.0,59.0
Andhra Pradesh,West Godavari,16.63297943925236,81.45912990654196,546,ANDHRA PRADESH,West Godavari,3936966,1964918,1972048,2652389,1379223,1273166,811698,403693,408005,109072,53367,55705,1773112,1199338,573774,1534166,238946,2163854,155275,1061787,33861,522189,3733191,86142,109120,288,209,1578,211,6227,100.0,67.0
Arunachal Pradesh,Changlang,27.36048479338845,96.37552644628106,253,ARUNACHAL PRADESH,Changlang,148226,76948,71278,73174,44027,29147,0,0,0,53878,27061,26817,62966,39329,23637,50765,12201,85260,39732,4208,496,18530,47683,2134,35969,94,50381,95,11738,132,93.0,49.0
Arunachal Pradesh,East Kameng,27.371194055944056,93.04741486013997,247,ARUNACHAL PRADESH,East Kameng,78690,38775,39915,38449,21599,16850,0,0,0,72400,35266,37134,31710,16424,15286,27123,4587,46980,21835,1063,273,8539,12333,652,37136,36,452,23,27868,190,103.0,49.0
Arunachal Pradesh,East Siang,28.15382352941176,95.06499226006191,251,ARUNACHAL PRADESH,East Siang,99214,50116,49098,62576,34210,28366,0,0,0,69979,34533,35446,40222,23591,16631,33578,6644,58992,20185,3565,493,15979,27854,2289,18254,69,776,30,49393,549,98.0,63.0
Arunachal Pradesh,Kurung Kumey,28.04853351800553,93.24531994459834,256,ARUNACHAL PRADESH,Kurung Kumey,92076,45318,46758,36606,20258,16348,0,0,0,90764,44459,46305,38044,18429,19615,24372,13672,54032,27417,2947,833,6847,4859,471,51189,43,121,81,34158,1154,103.0,40.0
Arunachal Pradesh,Lohit,27.946785273972623,96.59670770547945,259,ARUNACHAL PRADESH,Lohit,145726,76221,69505,83062,48380,34682,0,0,0,47410,23457,23953,60945,38910,22035,50754,10191,84781,29909,7789,786,22461,99020,3846,10684,210,24452,104,7277,133,91.0,57.0
Arunachal Pradesh,Lower Dibang Valley,28.32651730103806,95.76567335640142,258,ARUNACHAL PRADESH,Lower Dibang Valley,54080,28053,26027,31849,18087,13762,0,0,0,25974,12649,13325,22326,14102,8224,19829,2497,31754,9687,3354,233,9052,28915,2247,9213,33,2932,19,10393,328,93.0,59.0
Arunachal Pradesh,Lower Subansiri,27.70849297297297,93.96226108108112,255,ARUNACHAL PRADESH,Lower Subansiri,83030,41843,41187,54057,29470,24587,0,0,0,72911,35803,37108,30202,17339,12863,22669,7533,52828,13656,1968,435,14143,9551,1482,34402,27,193,13,37085,277,98.0,65.0
Arunachal Pradesh,Papum Pare,27.273529716981127,93.54468183962264,248,ARUNACHAL PRADESH,Papum Pare,176573,89182,87391,121048,65794,55254,0,0,0,117216,56469,60747,65772,41263,24509,51157,14615,110801,14104,1859,1543,48266,57027,6148,84397,310,4768,139,22586,1198,98.0,69.0
Arunachal Pradesh,Tawang,27.680683962264148,91.82504245283016,245,ARUNACHAL PRADESH,Tawang,49977,29151,20826,26073,17720,8353,0,0,0,34811,16770,18041,28561,19554,9007,24430,4131,21416,7631,1581,114,19235,11842,787,776,1164,34920,72,349,67,71.0,52.0
Arunachal Pradesh,Tirap,26.94406229508198,95.41470327868862,254,ARUNACHAL PRADESH,Tirap,111975,57604,54371,47974,29313,18661,0,0,0,98372,49365,49007,50169,27545,22624,44262,5907,61806,35967,1811,836,11555,20682,1103,83361,61,778,43,5325,622,94.0,43.0
Arunachal Pradesh,Upper Siang,28.8309244897959,95.00155765306124,252,ARUNACHAL PRADESH,Upper Siang,35320,18699,16621,18195,10723,7472,0,0,0,28468,14413,14055,17644,9968,7676,14524,3120,17676,9976,804,591,6273,5261,411,5643,27,2577,7,20967,427,89.0,52.0
Arunachal Pradesh,Upper Subansiri,28.277196566523585,93.8991435622318,249,ARUNACHAL PRADESH,Upper Subansiri,83448,41758,41690,45278,24807,20471,0,0,0,78323,38570,39753,33370,17898,15472,25717,7653,50078,21690,1846,481,9353,13474,521,8779,28,297,11,59449,889,100.0,54.0
Arunachal Pradesh,West Kameng,27.46486582278483,92.65015750452083,246,ARUNACHAL PRADESH,West Kameng,83947,46155,37792,48492,29566,18926,0,0,0,46380,22771,23609,42493,28313,14180,34752,7741,41454,14476,1705,801,25511,31265,1970,8466,328,36087,71,5556,204,82.0,58.0
Arunachal Pradesh,West Siang,28.106296920289843,94.53510344202908,250,ARUNACHAL PRADESH,West Siang,112274,58168,54106,64746,36777,27969,0,0,0,92783,45746,47037,49177,29156,20021,43000,6177,63097,28852,1384,298,18643,15881,2218,29969,577,3311,49,60005,264,93.0,58.0
Assam,Barpeta,26.427872264631056,90.97912010178116,303,ASSAM,Barpeta,1693622,867004,826618,897058,499038,398020,95320,49165,46155,27344,13530,13814,561824,445297,116527,439453,122371,1131798,205259,98946,30342,227277,492966,1198036,1020,112,49,399,14,1026,95.0,53.0
Assam,Bongaigaon,26.45012521994133,90.6734296187684,319,ASSAM,Bongaigaon,738804,375818,362986,434078,237114,196964,82784,42513,40271,18835,9377,9458,255806,197542,58264,191671,64135,482998,83442,47406,9485,115473,359145,371033,5924,384,236,871,9,1202,97.0,59.0
Assam,Cachar,24.815570668693017,92.86849650455927,316,ASSAM,Cachar,1736617,886284,850333,1174128,639946,534182,264897,136051,128846,17569,8736,8833,608062,469752,138310,471259,136803,1128555,120356,68664,24466,394576,1038985,654816,37635,280,341,1673,98,2789,96.0,68.0
Assam,Darrang,26.58463215962442,92.04141338028155,325,ASSAM,Darrang,928500,475273,453227,487039,268666,218373,40260,20566,19694,8419,4300,4119,324843,246864,77979,241456,83387,603657,129456,81617,10542,103228,327322,597392,1688,431,57,724,19,867,95.0,52.0
Assam,Dhemaji,27.586533438485816,94.71336908517353,308,ASSAM,Dhemaji,686133,351249,334884,423028,237761,185267,44225,23006,21219,325560,165449,160111,316800,186577,130223,201364,115436,369333,231937,19181,7224,58458,655052,13475,8711,297,911,167,6315,1205,95.0,62.0
Assam,Dibrugarh,27.30612284482757,95.0998282327587,310,ASSAM,Dibrugarh,1326335,676434,649901,884531,491361,393170,58876,30517,28359,102871,51835,51036,560557,368013,192544,391597,168960,765778,135194,61209,14362,349792,1198401,64526,52968,2261,4673,1055,46,2405,96.0,67.0
Assam,Goalpara,26.017277777777807,90.59869891598912,302,ASSAM,Goalpara,1008183,513292,494891,563577,304302,259275,45094,22999,22095,231570,116013,115557,362573,267118,95455,266376,96197,645610,126549,75828,14346,145850,347878,579929,77862,771,194,477,103,969,96.0,56.0
Assam,Golaghat,26.377219709794485,93.82583397823468,313,ASSAM,Golaghat,1066888,543161,523727,721764,396475,325289,62298,31807,30491,111765,56420,55345,479928,309104,170824,331210,148718,586960,190590,66616,15068,207654,917426,90312,50582,1131,3863,530,1347,1697,96.0,68.0
Assam,Hailakandi,24.457496089385486,92.59154664804475,318,ASSAM,Hailakandi,659296,337890,321406,407366,226836,180530,70659,36369,34290,691,354,337,214240,170792,43448,165193,49047,445056,65673,31248,7313,110006,251194,397653,8480,84,490,247,636,512,95.0,62.0
Assam,Jorhat,26.76244824016563,94.30197722567289,312,ASSAM,Jorhat,1092256,556805,535451,794929,432335,362594,88665,45194,43471,139971,70795,69176,498618,320746,177872,338635,159983,593638,145885,53153,31543,268037,1008219,54684,21051,1540,2378,719,578,3087,96.0,73.0
Assam,Kamrup,26.170939452054807,91.58863273972592,321,ASSAM,Kamrup,1517542,778461,739081,995319,550219,445100,107827,55237,52590,182038,92094,89944,628954,428492,200462,421244,207710,888588,185803,99522,69106,274523,877495,601784,33297,319,185,1330,55,3077,95.0,66.0
Assam,Karbi Anglong,26.08966454598031,93.11536570271832,314,ASSAM,Karbi Anglong,956313,490167,466146,557214,314253,242961,44961,23436,21525,538738,272460,266278,383441,246193,137248,260482,122959,572872,223020,60952,9861,89608,766000,20290,157789,370,6260,397,3568,1639,95.0,58.0
Assam,Karimganj,24.69660712250711,92.3679498575498,317,ASSAM,Karimganj,1228686,625864,602822,795297,435942,359355,157890,81384,76506,1940,994,946,399171,319798,79373,293392,105779,829515,94348,67033,17435,220355,521962,692489,11990,114,446,524,110,1051,96.0,65.0
Assam,Kokrajhar,26.497246635730868,90.13997470997688,300,ASSAM,Kokrajhar,887142,452905,434237,489305,275220,214085,29570,15386,14184,278665,139579,139086,341131,236322,104809,253110,88021,546011,156753,56330,12423,115625,529068,252271,101091,93,1718,396,123,2382,96.0,55.0
Assam,Lakhimpur,27.14128805970149,94.0775949253732,307,ASSAM,Lakhimpur,1042137,529674,512463,683486,375552,307934,81840,41689,40151,249426,126716,122710,429995,282250,147745,283533,146462,612142,239377,43922,10983,135713,797130,193476,46217,412,1074,250,2410,1168,97.0,66.0
Assam,Nagaon,26.26462170626351,92.9306191144708,305,ASSAM,Nagaon,2823768,1439112,1384656,1710716,921850,788866,266350,136473,129877,115153,57759,57394,979998,766728,213270,734993,245005,1843770,346123,196174,38122,399579,1225246,1563203,26844,3036,1073,1162,61,3143,96.0,61.0
Assam,Nalbari,26.46323767605632,91.40598521126763,323,ASSAM,Nalbari,771639,396006,375633,531771,293184,238587,60216,30654,29562,23364,11692,11672,267623,210202,57421,196773,70850,504016,58070,34984,19302,155267,491582,277488,429,62,27,1004,9,1038,95.0,69.0
Assam,Sonitpur,26.73514926829268,92.85197804878044,306,ASSAM,Sonitpur,1924110,983904,940206,1108572,620525,488047,109130,55817,53313,232207,117685,114522,770606,537195,233411,558325,212281,1153504,249123,114865,25719,380899,1422824,350536,138166,1363,5088,1003,221,4909,96.0,58.0
Assam,Tinsukia,27.53549291139241,95.69055949367085,309,ASSAM,Tinsukia,1327929,680231,647698,798322,453449,344873,37688,19443,18245,82066,41769,40297,557196,366623,190573,410188,147008,770733,149482,47756,13241,346717,1181347,48373,76877,1999,16228,837,395,1873,95.0,60.0
Bihar,Araria,26.211528119180603,87.30766554934816,209,BIHAR,Araria,2811569,1463333,1348236,1195768,727643,468125,382654,198247,184407,38848,19887,18961,1069893,708391,361502,696410,373483,1741676,222913,691947,24367,130666,1593525,1207442,4116,371,187,1910,63,3955,92.0,43.0
Bihar,Aurangabad,24.774291867469877,84.45986024096379,235,BIHAR,Aurangabad,2540073,1318684,1221389,1466002,868733,597269,612064,316161,295903,1033,500,533,837770,599157,238613,480286,357484,1702303,178525,426096,40652,192497,2291133,237353,2218,295,334,775,19,7946,93.0,58.0
Bihar,Aurangabad,24.774291867469877,84.45986024096379,515,MAHARASHTRA,Aurangabad,3701282,1924469,1776813,2503837,1430936,1072901,539368,277228,262140,143366,73876,69490,1575079,1015864,559215,1446636,128443,2126203,554518,396630,28033,595898,2545438,786677,15991,5142,309093,30981,1005,6955,92.0,68.0
Maharashtra,Aurangabad,20.0979228832952,75.32072196796334,235,BIHAR,Aurangabad,2540073,1318684,1221389,1466002,868733,597269,612064,316161,295903,1033,500,533,837770,599157,238613,480286,357484,1702303,178525,426096,40652,192497,2291133,237353,2218,295,334,775,19,7946,93.0,58.0
Maharashtra,Aurangabad,20.0979228832952,75.32072196796334,515,MAHARASHTRA,Aurangabad,3701282,1924469,1776813,2503837,1430936,1072901,539368,277228,262140,143366,73876,69490,1575079,1015864,559215,1446636,128443,2126203,554518,396630,28033,595898,2545438,786677,15991,5142,309093,30981,1005,6955,92.0,68.0
Bihar,Banka,24.832355642023337,86.8664916342413,225,BIHAR,Banka,2034763,1067140,967623,965321,590961,374360,247858,129663,118195,90432,45901,44531,771080,517817,253263,374097,396983,1263683,172440,462614,26680,109346,1772655,250925,6138,139,113,94,1035,3664,91.0,47.0
Bihar,Begusarai,25.54302613168723,86.12560144032932,222,BIHAR,Begusarai,2970541,1567660,1402881,1548673,918507,630166,432270,227481,204789,1597,848,749,938182,715345,222837,591811,346371,2032359,146035,430870,58167,303110,2554330,407348,2209,402,229,276,57,5690,89.0,52.0
Bihar,Bhagalpur,25.277192885375477,87.04213814229242,224,BIHAR,Bhagalpur,3037766,1615663,1422103,1573066,937669,635397,318569,169667,148902,67180,35545,31635,983528,740056,243472,534129,449399,2054238,135161,475228,60461,312678,2487866,537098,3556,415,180,1050,32,7569,88.0,52.0
Bihar,Bhojpur,25.50666439393939,84.49407803030304,231,BIHAR,Bhojpur,2728407,1430380,1298027,1599151,973486,625665,425402,222716,202686,13977,7363,6614,822493,640283,182210,512009,310484,1905914,190896,364875,47985,218737,2518216,197819,2165,544,647,1472,48,7496,91.0,59.0
Bihar,Buxar,25.48593018867924,84.08808081760995,232,BIHAR,Buxar,1706352,887977,818375,989807,593544,396263,251737,131821,119916,26824,14102,12722,538322,402180,136142,328547,209775,1168030,132472,251790,26122,127938,1591454,105423,2125,248,5090,97,57,1858,92.0,58.0
Bihar,Darbhanga,26.146187719298258,85.97387352472099,215,BIHAR,Darbhanga,3937385,2059949,1877436,1816634,1125566,691068,615688,322327,293361,2772,1361,1411,1223640,947927,275713,731347,492293,2713745,236673,642115,44846,300006,3042729,881476,3534,832,245,236,101,8232,91.0,46.0
Bihar,Gaya,24.7266541547278,84.94291217765044,236,BIHAR,Gaya,4391418,2266566,2124852,2297613,1368803,928810,1334351,683943,650408,3098,1635,1463,1664062,1076170,587892,1007057,657005,2727356,370759,783505,87178,422620,3876395,488121,3943,913,870,1723,108,19345,94.0,52.0
Bihar,Gopalganj,26.44874364161851,84.34636127167629,217,BIHAR,Gopalganj,2562012,1267666,1294346,1382998,793905,589093,320064,159265,160799,60807,29833,30974,728201,539586,188615,363111,365090,1833811,208959,338666,26049,154527,2119262,436057,2463,271,167,133,28,3631,102.0,54.0
Bihar,Jamui,24.78418380462726,86.26316298200514,238,BIHAR,Jamui,1760405,916064,844341,858588,534385,324203,302649,155849,146800,78793,40185,38608,727571,452288,275283,445352,282219,1032834,156491,331466,105637,133977,1525746,217621,8443,162,159,87,3438,4749,92.0,49.0
Bihar,Jehanabad,25.155679045643165,84.9208124481328,239,BIHAR,Jehanabad,1125313,585582,539731,618881,374412,244469,222974,115034,107940,1285,667,618,365378,266423,98955,251690,113688,759935,86108,179519,15075,84676,1045117,75742,691,148,248,60,58,3249,92.0,55.0
Bihar,Katihar,25.56565356037151,87.70466083591326,212,BIHAR,Katihar,3071029,1600430,1470599,1280190,762256,517934,263100,136429,126671,179971,92190,87781,1013566,760522,253044,667602,345964,2057463,168857,672291,20577,151841,1684589,1365645,8659,2754,212,507,2141,6522,92.0,42.0
Bihar,Khagaria,25.53558891454964,86.56593256351037,223,BIHAR,Khagaria,1666886,883786,783100,768028,461153,306875,247161,130191,116970,675,352,323,560805,398216,162589,306283,254522,1106081,104517,325731,20816,109741,1486989,175588,1253,143,79,86,115,2633,89.0,46.0
Bihar,Kishanganj,26.324336758321294,87.95045007235886,210,BIHAR,Kishanganj,1690400,866970,823430,745056,439921,305135,113118,57964,55154,64224,32506,31718,529064,421192,107872,384416,144648,1161336,107862,321867,11633,87702,531236,1149095,5783,398,183,1476,28,2201,95.0,44.0
Bihar,Lakhisarai,25.183449321266963,86.12825701357468,227,BIHAR,Lakhisarai,1000912,526345,474567,507270,305182,202088,153209,80069,73140,8333,4247,4086,326576,240494,86082,201866,124710,674336,78532,159970,13546,74528,956396,40886,487,140,52,78,52,2821,90.0,51.0
Bihar,Madhepura,25.77341929460581,86.8978443983403,213,BIHAR,Madhepura,2001762,1047559,954203,834577,517666,316911,346275,179337,166938,12532,6442,6090,777546,496046,281500,443507,334039,1224216,190809,484062,16347,86328,1753829,241760,1342,170,60,133,81,4387,91.0,42.0
Bihar,Madhubani,26.41380538172716,86.16328360450552,207,BIHAR,Madhubani,4487379,2329313,2158066,2155338,1340085,815253,587158,303389,283769,3990,2056,1934,1636938,1105947,530991,1074091,562847,2850441,396880,940642,54934,244482,3652168,818912,3262,564,328,442,169,11534,93.0,48.0
Bihar,Munger,25.198537962962963,86.54173672839504,226,BIHAR,Munger,1367765,729041,638724,801817,473741,328076,183846,97195,86651,21404,10995,10409,426658,327453,99205,233402,193256,941107,45953,196449,16690,167566,1252319,110416,1815,338,95,145,61,2576,88.0,59.0
Bihar,Muzaffarpur,26.18664417177915,85.32745092024543,216,BIHAR,Muzaffarpur,4801062,2527497,2273565,2509232,1487117,1022115,751975,393135,358840,5979,3124,2855,1547586,1195308,352278,910304,637282,3253476,273436,769001,65253,439896,4032773,745546,5149,933,288,382,98,15893,90.0,52.0
Bihar,Nalanda,25.229345508982053,85.48053113772461,229,BIHAR,Nalanda,2877653,1497060,1380593,1519933,919558,600375,607672,315240,292432,1442,728,714,1045420,703405,342015,740949,304471,1832233,221240,534021,52585,237574,2669775,198033,1978,393,414,561,64,6435,92.0,53.0
Bihar,Nawada,24.825708836206903,85.61594568965519,237,BIHAR,Nawada,2219146,1144668,1074478,1091012,659474,431538,565112,290050,275062,2045,997,1048,817041,539439,277602,508509,308532,1402105,216400,397505,40018,163118,1964620,244394,1299,250,176,279,80,8048,94.0,49.0
Bihar,Pashchim Champaran,27.16064352201258,84.30265911949685,203,BIHAR,Pashchim Champaran,3935042,2061110,1873932,1759481,1091226,668255,553944,289191,264753,250046,127680,122366,1478947,999282,479665,797544,681403,2456095,217539,998833,38691,223884,3047427,865090,8469,926,1337,296,1895,9602,91.0,45.0
Bihar,Patna,25.40297114503818,85.3198433587787,230,BIHAR,Patna,5838465,3078512,2759953,3459679,2028047,1431632,920918,482088,438830,9069,4717,4352,1881886,1436411,445475,1371267,510619,3956579,271216,658203,85349,867118,5356075,439952,12551,4803,1062,2151,203,21668,90.0,59.0
Bihar,Purba Champaran,26.68129336734693,85.00382155612242,204,BIHAR,Purba Champaran,5099371,2681209,2418162,2276957,1407603,869354,649726,340363,309363,12461,6454,6007,1737539,1260774,476765,1132789,604750,3361832,349032,1057417,46164,284926,4086453,990349,4865,668,878,464,104,15590,90.0,45.0
Bihar,Purnia,25.81714801901739,87.40447606973065,211,BIHAR,Purnia,3264619,1699370,1565249,1332326,805261,527065,390991,203201,187790,139490,71391,68099,1143318,803275,340043,776385,366933,2121301,197424,745015,28840,172039,1989420,1255641,7989,614,353,1450,650,8502,92.0,41.0
Bihar,Rohtas,24.99170460829495,83.9350762672811,234,BIHAR,Rohtas,2959918,1543546,1416372,1799832,1061783,738049,549546,286596,262950,31650,16399,15251,924879,707939,216940,542439,382440,2035039,218087,405544,48512,252736,2645415,300487,2889,2569,1584,252,537,6185,92.0,61.0
Bihar,Saharsa,25.821270696721303,86.54670819672135,214,BIHAR,Saharsa,1900661,997174,903487,804996,506374,298622,317249,164518,152731,6009,3101,2908,649898,456724,193174,363326,286572,1250763,164600,356833,18651,109814,1629254,266620,1292,197,60,109,8,3121,91.0,42.0
Bihar,Samastipur,25.793205563909765,85.94833323308269,221,BIHAR,Samastipur,4261566,2230003,2031563,2142880,1293575,849305,803128,417944,385184,1884,975,909,1343400,1037576,305824,907433,435967,2918166,299039,721629,47917,274815,3800598,452370,2126,554,292,231,112,5283,91.0,50.0
Bihar,Saran,25.89656077844312,84.82266287425155,219,BIHAR,Saran,3951862,2022821,1929041,2157454,1285767,871687,474066,242976,231090,36786,18322,18464,1040231,857660,182571,545520,494711,2911631,232097,493461,42103,272570,3534772,406449,2330,371,229,322,107,7282,95.0,55.0
Bihar,Sheikhpura,25.12472436548223,85.77839390862943,228,BIHAR,Sheikhpura,636342,329743,306599,328676,196431,132245,131115,67582,63533,617,305,312,224655,151569,73086,148002,76653,411687,54511,109696,9917,50531,596102,37653,313,75,41,43,31,2084,93.0,52.0
Bihar,Sheohar,26.458380748663107,85.29539411764709,205,BIHAR,Sheohar,656246,346673,309573,283698,171645,112053,96655,51089,45566,318,177,141,216372,166693,49679,137804,78568,439874,38727,136334,9119,32192,552492,99342,522,216,73,52,44,3505,89.0,43.0
Bihar,Sitamarhi,26.56570069686413,85.61172491289203,206,BIHAR,Sitamarhi,3423574,1803252,1620322,1436794,885188,551606,405714,213624,192090,2989,1585,1404,1114583,865929,248654,753645,360938,2308991,216012,635907,37932,224732,2672311,740101,2897,261,253,188,20,7543,90.0,42.0
Bihar,Siwan,26.1736372013652,84.33766552901022,218,BIHAR,Siwan,3330464,1675090,1655374,1930175,1115906,814269,386685,195965,190720,87000,43472,43528,932416,730396,202020,462104,470312,2398048,264928,376344,31244,259900,2712635,608282,2618,369,407,359,86,5708,99.0,58.0
Bihar,Supaul,26.28157893772896,86.78496465201461,208,BIHAR,Supaul,2229076,1155283,1073793,1033283,647672,385611,354249,182545,171704,10168,5242,4926,877682,551718,325964,472649,405033,1351394,201882,554271,22555,98974,1809936,409251,3758,271,136,546,42,5136,93.0,46.0
Bihar,Vaishali,25.8134703180212,85.39247597173153,220,BIHAR,Vaishali,3495021,1844535,1650486,1926740,1152576,774164,738031,387827,350204,2274,1232,1042,1060344,858648,201696,716006,344338,2434677,255017,502637,36958,265732,3152346,333980,2203,707,362,246,71,5106,89.0,55.0
Chandigarh,Chandigarh,30.7426,76.75872465753424,55,CHANDIGARH,Chandigarh,1055450,580663,474787,805438,465346,340092,199086,106356,92730,0,0,0,404136,328159,75977,385929,18207,651314,2578,1687,4799,395072,852574,51447,8720,138329,1160,1960,246,1014,82.0,76.0
Chhattisgarh,Bastar,19.393866751269048,81.52895126903546,414,CHHATTISGARH,Bastar,1413199,698487,714712,650863,382335,268528,37963,18815,19148,931780,456841,474939,726531,404364,322167,394824,331707,686668,284472,287828,10821,143410,1277975,12413,27951,2099,985,3466,86925,1385,102.0,46.0
Chhattisgarh,Bilaspur,22.356942982456143,81.99770350877188,30,HIMACHAL PRADESH,Bilaspur,381956,192764,189192,287620,155599,132021,98989,50271,48718,10693,5485,5208,205871,111543,94328,103406,102465,176085,127169,4138,2561,72003,371973,6984,236,2387,113,10,7,246,98.0,75.0
Chhattisgarh,Bilaspur,22.356942982456143,81.99770350877188,406,CHHATTISGARH,Bilaspur,2663629,1351574,1312055,1596560,932474,664086,552992,281221,271771,498469,248172,250297,1203197,715467,487730,826568,376629,1460432,276691,572292,21658,332556,2540763,57973,20745,6373,2979,2357,29122,3317,97.0,60.0
Himachal Pradesh,Bilaspur,31.3780422907489,76.65316079295157,30,HIMACHAL PRADESH,Bilaspur,381956,192764,189192,287620,155599,132021,98989,50271,48718,10693,5485,5208,205871,111543,94328,103406,102465,176085,127169,4138,2561,72003,371973,6984,236,2387,113,10,7,246,98.0,75.0
Himachal Pradesh,Bilaspur,31.3780422907489,76.65316079295157,406,CHHATTISGARH,Bilaspur,2663629,1351574,1312055,1596560,932474,664086,552992,281221,271771,498469,248172,250297,1203197,715467,487730,826568,376629,1460432,276691,572292,21658,332556,2540763,57973,20745,6373,2979,2357,29122,3317,97.0,60.0
Chhattisgarh,Dhamtari,20.554912627291245,81.7569195519348,412,CHHATTISGARH,Dhamtari,799781,397897,401884,546833,303924,242909,58581,28887,29694,207633,102058,105575,402895,226382,176513,335368,67527,396886,135435,182602,7310,77548,777188,10425,2644,1196,667,3612,3685,364,101.0,68.0
Chhattisgarh,Durg,21.194463849287164,81.33181639511197,409,CHHATTISGARH,Durg,3343872,1682101,1661771,2303378,1284612,1018766,458040,229067,228973,397416,196008,201408,1496805,921729,575076,1206793,290012,1847067,392341,560415,22565,521484,3129745,83499,24304,24276,19587,17209,42569,2683,99.0,69.0
Chhattisgarh,Jashpur,22.77286167664669,83.8703962075848,402,CHHATTISGARH,Jashpur,851669,424747,426922,495415,280656,214759,48844,24317,24527,530378,262731,267647,487360,263645,223715,291349,196011,364309,226866,197558,7553,55383,629509,15336,189588,474,467,694,14835,766,101.0,58.0
Chhattisgarh,Korba,22.491712499999995,82.57604326923074,404,CHHATTISGARH,Korba,1206640,612915,593725,748759,433391,315368,124679,63446,61233,493559,246323,247236,521186,333329,187857,350314,170872,685454,113071,221806,7899,178410,1133176,30195,21059,3666,897,753,15649,1245,97.0,62.0
Chhattisgarh,Koriya,23.50412776859501,82.12515636363635,400,CHHATTISGARH,Koriya,658917,334737,324180,397823,229923,167900,54776,27682,27094,304280,152659,151621,307071,185483,121588,173057,134014,351846,118498,94648,4830,89095,604259,25878,9398,1391,84,1155,15474,1278,97.0,60.0
Chhattisgarh,Mahasamund,21.223727037773354,82.65925427435384,411,CHHATTISGARH,Mahasamund,1032754,511967,520787,637963,364089,273874,139581,68968,70613,279896,137339,142557,499260,291858,207402,340802,158458,533494,139199,278073,6135,75853,1008061,12570,5284,2941,521,1495,1417,465,102.0,62.0
Chhattisgarh,Raigarh,22.008265068493166,83.27797698630134,403,CHHATTISGARH,Raigarh,1493984,750278,743706,951639,542756,408883,224942,112111,112831,505609,250473,255136,690167,429211,260956,484875,205292,803817,208313,323788,9959,148107,1422986,17332,47653,2117,781,409,1782,924,99.0,64.0
Chhattisgarh,Raigarh,22.008265068493166,83.27797698630134,520,MAHARASHTRA,Raigarh,2634200,1344345,1289855,1939994,1059692,880302,134952,67980,66972,305125,153657,151468,1072969,753843,319126,858825,214144,1561231,206975,191182,32919,641893,2239370,227465,17452,7477,121791,12260,1159,7226,96.0,74.0
Maharashtra,Raigarh,18.453257637845976,73.0090609418579,403,CHHATTISGARH,Raigarh,1493984,750278,743706,951639,542756,408883,224942,112111,112831,505609,250473,255136,690167,429211,260956,484875,205292,803817,208313,323788,9959,148107,1422986,17332,47653,2117,781,409,1782,924,99.0,64.0
Maharashtra,Raigarh,18.453257637845976,73.0090609418579,520,MAHARASHTRA,Raigarh,2634200,1344345,1289855,1939994,1059692,880302,134952,67980,66972,305125,153657,151468,1072969,753843,319126,858825,214144,1561231,206975,191182,32919,641893,2239370,227465,17452,7477,121791,12260,1159,7226,96.0,74.0
Chhattisgarh,Raipur,20.88603153846152,82.20032759615388,410,CHHATTISGARH,Raipur,4063872,2048186,2015686,2629749,1493158,1136591,724250,362284,361966,476446,235271,241175,1757664,1099964,657700,1259138,498526,2306208,383279,708993,34078,631314,3881485,103038,23181,16707,8397,17137,10680,3247,98.0,65.0
Chhattisgarh,Surguja,23.32719278728607,83.23582493887531,401,CHHATTISGARH,Surguja,2359886,1193129,1166757,1187941,694686,493255,115652,58281,57371,1300628,652799,647829,1155807,649888,505919,622589,533218,1204079,465287,523356,12643,154521,2126195,81442,97432,2303,1287,623,48295,2309,98.0,50.0
Daman and Diu,Daman,20.431616666666677,72.8392366071429,495,DAMAN AND DIU,Daman,191173,124659,66514,150348,104316,46032,4262,2224,2038,15240,7702,7538,105521,94502,11019,101717,3804,85652,1845,481,409,102786,171537,16087,2618,169,216,244,79,223,53.0,79.0
Daman and Diu,Junagadh,20.72568199498111,70.83985639899612,479,GUJARAT,Junagadh,2743082,1404356,1338726,1842818,1046981,795837,265793,136319,129474,55571,28463,27108,1123709,801859,321850,942709,181000,1619373,367311,333996,9645,412757,2397056,334858,2586,1110,1291,3841,77,2263,95.0,67.0
Gujarat,Junagadh,20.929523011609785,70.54733890140345,479,GUJARAT,Junagadh,2743082,1404356,1338726,1842818,1046981,795837,265793,136319,129474,55571,28463,27108,1123709,801859,321850,942709,181000,1619373,367311,333996,9645,412757,2397056,334858,2586,1110,1291,3841,77,2263,95.0,67.0
Goa,North Goa,15.548723418714054,73.80667997909038,585,GOA,North Goa,818008,416677,401331,663060,351738,311322,17606,8712,8894,56606,27824,28782,327658,239125,88533,269437,58221,490350,15402,14120,8862,289274,622213,57941,134169,618,553,546,166,1802,96.0,81.0
Goa,South Goa,15.195278658183785,73.941792596877,586,GOA,South Goa,640537,322463,318074,502427,264085,238342,7843,3915,3928,92669,45124,47545,249590,180411,69179,206616,42974,390947,15952,12640,5846,215152,341664,63623,231961,855,542,563,92,1237,99.0,78.0
Gujarat,Ahmadabad,22.605425564971743,72.23898135593227,474,GUJARAT,Ahmadabad,7214225,3788051,3426174,5435760,3025463,2410297,759483,399075,360408,89138,47106,42032,2594952,2127547,467405,2332409,262543,4619273,142670,268954,54876,2128452,6042416,883238,50754,14542,4518,209287,2055,7415,90.0,75.0
Gujarat,Amreli,21.04832649310872,71.43457637825426,480,GUJARAT,Amreli,1514190,771049,743141,995459,558180,437279,132915,68518,64397,7322,3856,3466,657139,453642,203497,529153,127986,857051,232126,209935,6083,208995,1410463,99105,919,415,243,2053,40,952,96.0,66.0
Gujarat,Anand,22.282718206229863,72.57782051557454,482,GUJARAT,Anand,2092745,1087224,1005521,1551253,874481,676772,104465,54476,49989,24824,12761,12063,844794,627561,217233,690031,154763,1247951,152412,346329,16460,329593,1798794,250919,29789,1524,267,8591,142,2719,92.0,74.0
Gujarat,Banas Kantha,24.258538965517253,71.93205252873561,469,GUJARAT,Banas Kantha,3120506,1610379,1510127,1704923,1048402,656521,327460,169288,158172,284155,144355,139800,1248600,836268,412332,1012080,236520,1871906,475585,350541,11812,410662,2890305,213505,1686,486,281,12659,83,1501,94.0,55.0
Gujarat,Bharuch,21.75787276237761,72.67326346710801,488,GUJARAT,Bharuch,1551019,805707,745312,1118276,623047,495229,62235,31979,30256,488194,250398,237796,627124,468919,158205,526541,100583,923895,78120,253577,8902,286525,1188204,343511,9494,1733,442,4813,342,2480,93.0,72.0
Gujarat,Bhavnagar,21.70219390341736,72.16272632761141,481,GUJARAT,Bhavnagar,2880365,1490201,1390164,1887255,1087371,799884,157034,80827,76207,9110,4751,4359,1150632,838781,311851,992140,158492,1729733,231796,334025,17996,566815,2632574,212863,3457,1410,445,26974,127,2515,93.0,66.0
Gujarat,Gandhinagar,23.193679790026252,72.67221679790026,473,GUJARAT,Gandhinagar,1391753,723864,667889,1030494,582686,447808,108608,56919,51689,18204,9711,8493,534976,408075,126901,451951,83025,856777,104147,129356,8600,292873,1319586,57273,3237,1985,497,6405,82,2688,92.0,74.0
Gujarat,Jamnagar,22.410600414263328,69.62062005768233,477,GUJARAT,Jamnagar,2160119,1114192,1045927,1396534,795140,601394,173895,89597,84298,24187,12415,11772,847440,646822,200618,721253,126187,1312679,264318,147193,11359,424570,1810443,320805,4392,1873,1086,18856,136,2528,94.0,65.0
Gujarat,Kachchh,23.48057203301311,68.82192301497916,468,GUJARAT,Kachchh,2092371,1096737,995634,1252319,739239,513080,258859,133224,125635,24228,12825,11403,776228,624704,151524,686937,89291,1316143,105876,183971,10802,475579,1608921,442355,6192,6353,490,25312,98,2650,91.0,60.0
Gujarat,Kheda,22.88765312500002,73.018803515625,483,GUJARAT,Kheda,2299885,1185727,1114158,1660243,942480,717763,115631,59734,55897,40336,21057,19279,933983,674586,259397,722134,211849,1365902,239241,359842,12455,322445,2000884,264482,26629,1403,300,3479,82,2626,94.0,72.0
Gujarat,Mahesana,23.529355452865065,72.45545194085031,471,GUJARAT,Mahesana,2035064,1056520,978544,1502645,847499,655146,162288,84470,77818,9392,4879,4513,812064,588699,223365,698768,113296,1223000,189760,242969,10282,369053,1885732,136431,1954,1082,146,7087,88,2544,93.0,74.0
Gujarat,Narmada,21.70666386292833,73.68403208722742,487,GUJARAT,Narmada,590297,301086,289211,370336,211767,158569,8733,4465,4268,481392,244524,236868,294795,174282,120513,193916,100879,295502,62823,188030,2594,41348,559848,22600,4413,147,80,373,2078,758,96.0,63.0
Gujarat,Navsari,20.866973318871995,72.86184869848157,490,GUJARAT,Navsari,1329672,678165,651507,1001909,539471,462438,35464,17959,17505,639659,319740,319919,591834,407881,183953,510004,81830,737838,112809,206608,7173,265244,1225087,78669,5733,2459,601,13386,2823,914,96.0,75.0
Gujarat,Panch Mahals,22.80435606837605,73.61984598290586,484,GUJARAT,Panch Mahals,2390776,1226961,1163815,1440805,858054,582751,100446,51278,49168,721604,368348,353256,1097507,673565,423942,685141,412366,1293269,456768,376038,10771,253930,2220974,158513,2863,662,337,5236,131,2060,95.0,60.0
Gujarat,Patan,23.80634198473284,71.75162977099237,470,GUJARAT,Patan,1343734,694397,649337,837913,494631,343282,123408,64190,59218,13303,6835,6468,554830,383074,171756,446240,108590,788904,136590,227080,6392,184768,1194745,142797,916,337,66,3602,66,1205,94.0,62.0
Gujarat,Porbandar,21.55092351651571,69.71896987722886,478,GUJARAT,Porbandar,585449,300209,285240,393678,221621,172057,51830,26607,25223,13039,6730,6309,231169,174118,57051,195437,35732,354280,65702,48964,2371,114132,549749,33565,500,248,91,515,38,743,95.0,67.0
Gujarat,Rajkot,22.40603377715488,70.83679439383323,476,GUJARAT,Rajkot,3804558,1974445,1830113,2725056,1514075,1210981,290169,149782,140387,24017,12504,11513,1479050,1159480,319570,1324783,154267,2325508,349357,214285,23780,891628,3397406,361388,5478,1918,1170,33591,269,3338,93.0,72.0
Gujarat,Sabar Kantha,23.71803594548552,73.13638790459964,472,GUJARAT,Sabar Kantha,2428589,1244231,1184358,1578734,918625,660109,187685,96527,91158,542156,272531,269625,1084878,681435,403443,795096,289782,1343711,366711,333867,10909,373391,2260560,148563,6375,614,168,11110,52,1147,95.0,65.0
Gujarat,Surat,21.25761372772093,72.93488716344339,492,GUJARAT,Surat,6081322,3402224,2679098,4571410,2687468,1883942,158115,82202,75913,856952,432089,424863,2553542,2142819,410723,2405288,148254,3527780,109549,325739,42040,2076214,5260193,660772,21052,5703,12902,112835,3920,3945,79.0,75.0
Gujarat,Surendranagar,22.82672007299272,71.48358740875906,475,GUJARAT,Surendranagar,1756268,909917,846351,1093626,643221,450405,179461,93427,86034,21453,11068,10385,723500,504038,219462,586364,137136,1032768,185235,270861,9518,257886,1620282,109681,1419,512,312,22992,128,942,93.0,62.0
Gujarat,The Dangs,20.801633877551023,73.6883518367347,489,GUJARAT,The Dangs,228291,113821,114470,140968,77314,63654,992,490,502,216073,107539,108534,118257,61329,56928,88038,30219,110034,64561,40486,1172,12038,203545,3593,20029,69,32,39,560,424,101.0,62.0
Gujarat,Vadodara,22.26133739279589,73.49433010291594,486,GUJARAT,Vadodara,4165626,2153736,2011890,2893080,1614087,1278993,221629,114602,107027,1149901,586665,563236,1693473,1233312,460161,1360660,332813,2472153,312126,570361,17680,793306,3713941,384579,23813,9340,2069,27650,1124,3110,93.0,69.0
Gujarat,Valsad,20.44238231644259,72.9148584798345,491,GUJARAT,Valsad,1705678,887222,818456,1170657,655528,515129,38237,19557,18680,902794,450976,451818,743245,516188,227057,577327,165918,962433,147569,183025,11833,400818,1571147,94034,19661,1589,913,13809,1417,3108,92.0,69.0
Haryana,Ambala,30.3503672316384,76.94970310734456,70,HARYANA,Ambala,1128350,598703,529647,818025,461288,356737,296246,156874,139372,0,0,0,372139,320120,52019,319475,52664,756211,52871,57293,15753,246222,955096,22143,3705,138202,381,4845,110,3868,88.0,72.0
Haryana,Bhiwani,28.728868064516128,76.02110225806452,81,HARYANA,Bhiwani,1634445,866672,767773,1069871,643158,426713,341162,181475,159687,0,0,0,623006,430678,192328,445675,177331,1011439,288543,103788,14855,215820,1611031,15515,873,2401,254,1016,26,3329,89.0,65.0
Haryana,Faridabad,28.14873109756098,77.32718536585368,88,HARYANA,Faridabad,1809733,966110,843623,1272739,734940,537799,223799,119495,104304,0,0,0,579229,476933,102296,495316,83913,1230504,27705,29288,32286,489950,1588407,161680,9743,34572,640,4883,249,9559,87.0,70.0
Haryana,Fatehabad,29.57298318584072,75.54608716814157,78,HARYANA,Fatehabad,942011,495360,446651,557578,327471,230107,284357,149111,135246,0,0,0,369083,263498,105585,286258,82825,572928,132250,97997,6558,132278,779243,8360,996,150969,171,1172,530,570,90.0,59.0
Haryana,Gurgaon,28.043894789579163,77.01935130260523,86,HARYANA,Gurgaon,1514432,816690,697742,1111116,638666,472450,197937,104332,93605,0,0,0,544716,432456,112260,487441,57275,969716,56046,27097,18228,443345,1408801,70842,9725,15097,944,7451,254,1318,85.0,73.0
Haryana,Hisar,29.23628731117825,75.84324682779452,80,HARYANA,Hisar,1743931,931562,812369,1114311,670200,444111,408785,217338,191447,0,0,0,691621,488321,203300,531227,160394,1052310,261120,144213,16097,270191,1701061,21650,1945,12270,334,3620,33,3018,87.0,64.0
Haryana,Jhajjar,28.59651868131869,76.61137142857145,83,HARYANA,Jhajjar,958405,514667,443738,676091,399480,276611,170448,90856,79592,0,0,0,326534,250020,76514,246457,80077,631871,112389,44845,9254,160046,945693,8247,734,1042,105,645,22,1917,86.0,71.0
Haryana,Jind,29.45149821958457,76.29598575667653,77,HARYANA,Jind,1334152,713006,621146,832758,502049,330709,282351,150940,131411,0,0,0,523422,368277,155145,385851,137571,810730,230387,102071,9114,181850,1276669,23016,889,29103,172,2594,56,1653,87.0,62.0
Haryana,Kaithal,29.96068539094649,76.37698930041155,73,HARYANA,Kaithal,1074304,571003,503301,646529,385782,260747,247513,131486,116027,0,0,0,373899,292696,81203,290663,83236,700405,128016,85651,9450,150782,974520,8232,1769,87558,265,351,70,1539,88.0,60.0
Haryana,Karnal,29.703200647249204,76.87488025889972,74,HARYANA,Karnal,1505324,797712,707612,978013,564516,413497,339604,179681,159923,0,0,0,516062,411646,104416,411533,104529,989262,112288,133723,15311,254740,1341002,31650,2049,126207,532,1516,49,2319,89.0,65.0
Haryana,Kurukshetra,30.05652659846548,76.78774680306903,72,HARYANA,Kurukshetra,964655,510976,453679,646893,370828,276065,215128,113311,101817,0,0,0,336780,268556,68224,285904,50876,627875,68908,85890,6726,175256,805175,15970,1943,140395,214,375,106,477,89.0,67.0
Haryana,Mahendragarh,28.1352161458333,76.14018072916659,84,HARYANA,Mahendragarh,922088,486665,435423,630255,380440,249815,156314,82420,73894,0,0,0,338584,232935,105649,212402,126182,583504,149146,38320,7639,143479,913251,5660,301,1737,75,644,15,405,89.0,68.0
Haryana,Panchkula,30.700897142857134,76.97173238095236,69,HARYANA,Panchkula,561293,299679,261614,405318,229862,175456,101830,53868,47962,0,0,0,211479,164865,46614,182831,28648,349814,26682,12827,9870,162100,490702,23451,2583,40951,1008,1626,90,882,87.0,72.0
Haryana,Panipat,29.34352134146342,76.92895914634147,75,HARYANA,Panipat,1205437,646857,558580,786599,464136,322463,206213,109695,96518,0,0,0,412318,328667,83651,339016,73302,793119,72120,62358,15824,262016,1083936,86622,2261,25064,289,4647,99,2519,86.0,65.0
Haryana,Rewari,28.19164714828897,76.55956007604564,85,HARYANA,Rewari,900332,474335,425997,636947,375453,261494,182606,95571,87035,0,0,0,337727,235326,102401,250219,87508,562605,102698,28215,9782,197032,889133,5713,701,1804,202,1525,12,1242,90.0,71.0
Haryana,Rohtak,28.892517647058817,76.53123235294117,82,HARYANA,Rohtak,1061204,568479,492725,747582,436025,311557,216889,115573,101316,0,0,0,345967,272646,73321,288949,57018,715237,95732,36568,8521,205146,1043887,8185,732,3916,200,3491,24,769,87.0,70.0
Haryana,Sirsa,29.63583446327684,74.90970480225988,79,HARYANA,Sirsa,1295189,682582,612607,782897,456968,325929,387381,202430,184951,0,0,0,502003,369462,132541,399169,102834,793186,164297,147042,11952,178712,940255,9524,2186,338962,370,2256,624,1012,90.0,60.0
Himachal Pradesh,Chamba,32.66741814595661,76.39354063116366,23,HIMACHAL PRADESH,Chamba,519080,261320,257760,323842,186064,137778,111690,56154,55536,135500,67900,67600,294035,158791,135244,119632,174403,225045,196665,9193,4521,83656,479782,32455,1559,2745,1740,57,14,728,99.0,62.0
Himachal Pradesh,Hamirpur,31.67668481012659,76.49767088607594,28,HIMACHAL PRADESH,Hamirpur,454768,217070,237698,358091,180555,177536,109256,53727,55529,3044,1531,1513,241931,118724,123207,126153,115778,212837,147103,8824,3347,82657,449412,3711,243,591,95,293,9,414,110.0,79.0
Himachal Pradesh,Hamirpur,31.67668481012659,76.49767088607594,168,UTTAR PRADESH,Hamirpur,1104285,593537,510748,653299,408125,245174,241198,130269,110929,474,259,215,443655,308527,135128,290375,153280,660630,130314,181449,19876,112016,1010014,91269,814,196,74,41,273,1604,86.0,59.0
Uttar Pradesh,Hamirpur,25.738158381502892,79.82619479768789,28,HIMACHAL PRADESH,Hamirpur,454768,217070,237698,358091,180555,177536,109256,53727,55529,3044,1531,1513,241931,118724,123207,126153,115778,212837,147103,8824,3347,82657,449412,3711,243,591,95,293,9,414,110.0,79.0
Uttar Pradesh,Hamirpur,25.738158381502892,79.82619479768789,168,UTTAR PRADESH,Hamirpur,1104285,593537,510748,653299,408125,245174,241198,130269,110929,474,259,215,443655,308527,135128,290375,153280,660630,130314,181449,19876,112016,1010014,91269,814,196,74,41,273,1604,86.0,59.0
Himachal Pradesh,Kangra,32.14093603238864,76.41205910931173,24,HIMACHAL PRADESH,Kangra,1510075,750591,759484,1152640,606443,546197,319385,159697,159688,84564,41745,42819,675170,403756,271414,313915,361255,834905,303007,54849,15662,301652,1461140,19797,3023,8929,14511,194,208,2273,101.0,76.0
Himachal Pradesh,Kinnaur,31.60667184065933,78.51613736263741,34,HIMACHAL PRADESH,Kinnaur,84121,46249,37872,60699,36697,24002,14750,7433,7317,48746,23609,25137,56273,33863,22410,46782,9491,27848,32995,2537,944,19797,64732,448,485,249,18086,29,45,47,82.0,72.0
Himachal Pradesh,Kullu,31.90911922077925,77.40922649350647,26,HIMACHAL PRADESH,Kullu,437903,225452,212451,307672,174550,133122,122659,62686,59973,16822,8493,8329,269084,148829,120255,193876,75208,168819,197141,12372,2707,56864,415669,2974,1568,1396,15377,94,83,742,94.0,70.0
Himachal Pradesh,Mandi,31.635805940594054,76.96556930693067,27,HIMACHAL PRADESH,Mandi,999777,498065,501712,723747,393669,330078,293739,147250,146489,12787,6345,6442,572671,297464,275207,284154,288517,427106,387944,15822,7134,161771,981412,9460,876,4081,2628,43,86,1191,101.0,72.0
Himachal Pradesh,Shimla,31.155725451807253,77.62573042168668,33,HIMACHAL PRADESH,Shimla,814010,425039,388971,612642,342846,269796,215777,110828,104949,8755,4554,4201,430926,258628,172298,311770,119156,383084,249786,26114,7967,147059,791449,11810,2025,4047,3262,185,197,1035,92.0,75.0
Himachal Pradesh,Sirmaur,30.682764453961443,77.43184689507493,32,HIMACHAL PRADESH,Sirmaur,529855,276289,253566,362645,205617,157028,160745,83017,77728,11262,5912,5350,280083,169399,110684,193906,86177,249772,182958,10730,5313,81082,476830,33215,577,15501,2645,236,86,765,92.0,68.0
Himachal Pradesh,Solan,31.03864311926604,76.94442140672783,31,HIMACHAL PRADESH,Solan,580320,308754,271566,428578,244372,184206,164536,85482,79054,25645,13351,12294,298737,190001,108736,219235,79502,281583,141267,10283,4969,142218,548579,14678,1452,13926,574,591,110,410,88.0,74.0
Himachal Pradesh,Una,31.58330388349513,76.18353932038836,29,HIMACHAL PRADESH,Una,521173,263692,257481,399715,213281,186434,115491,58601,56890,8601,4445,4156,215346,141612,73734,134482,80864,305827,84800,19604,3427,107515,480138,14275,390,26009,56,70,10,225,98.0,77.0
Jammu and Kashmir,Doda,33.359614675767915,76.07163720136518,16,JAMMU AND KASHMIR,Doda,409936,213641,196295,219083,138620,80463,53408,27209,26199,39216,20377,18839,151912,101144,50768,79377,72535,258024,69947,12199,1932,67834,187621,220614,472,422,21,22,42,722,92.0,53.0
Jammu and Kashmir,Jammu,32.713199095022645,74.8477520361991,21,JAMMU AND KASHMIR,Jammu,1529958,813821,716137,1137135,641916,495219,377991,197610,180381,69193,36323,32870,508622,417456,91166,410344,98278,1021336,68613,36873,10589,392547,1289240,107489,12104,114272,470,1987,321,4075,88.0,74.0
Jammu and Kashmir,Kargil,33.565994894894914,76.63675315315312,4,JAMMU AND KASHMIR,Kargil,140802,77785,63017,86236,56301,29935,18,12,6,122336,62652,59684,51873,39839,12034,28941,22932,88929,8266,3763,1222,38622,10341,108239,604,1171,20126,28,4,289,81.0,61.0
Jammu and Kashmir,Kathua,32.51781678321678,75.58901398601404,7,JAMMU AND KASHMIR,Kathua,616435,326109,290326,389204,228499,160705,141224,74644,66580,53307,27693,25614,200431,161548,38883,142847,57584,416004,69533,21566,3952,105380,540063,64234,1828,9551,24,16,2,717,89.0,63.0
Jammu and Kashmir,Pulwama,33.88414418604652,75.00921860465118,12,JAMMU AND KASHMIR,Pulwama,560440,293064,267376,293958,178326,115632,402,397,5,22607,11837,10770,188420,138428,49992,98306,90114,372020,49746,34080,10615,93979,13840,535159,1109,9440,35,6,18,833,91.0,52.0
Jammu and Kashmir,Punch,33.791241290322574,74.29593161290322,5,JAMMU AND KASHMIR,Punch,476835,251899,224936,261724,163333,98391,556,406,150,176101,90274,85827,161393,117677,43716,73247,88146,315442,54264,31583,3930,71616,32604,431279,958,11188,83,10,2,711,89.0,55.0
Jammu and Kashmir,Srinagar,34.27312898550724,75.11021159420288,10,JAMMU AND KASHMIR,Srinagar,1236829,651124,585705,748584,431746,316838,1068,995,73,8935,5021,3914,407188,333151,74037,330547,76641,829641,12228,10408,20095,364457,42540,1177342,2746,12187,285,74,2,1653,90.0,61.0
Jammu and Kashmir,Udhampur,33.04770670731707,75.15286951219511,19,JAMMU AND KASHMIR,Udhampur,554985,296784,258201,322354,197543,124811,138569,72093,66476,56309,29142,27167,243672,163845,79827,152442,91230,311313,113020,11396,2641,116615,489044,59771,1962,3418,106,57,235,392,87.0,58.0
Jharkhand,Bokaro,23.6814965034965,85.98398374125864,355,JHARKHAND,Bokaro,2062330,1072807,989523,1273520,759088,514432,299227,154297,144930,255626,129233,126393,685368,507677,177691,380304,305064,1376962,137521,126406,21671,399770,1636460,241451,13730,4174,1890,2045,160524,2056,92.0,62.0
Jharkhand,Chatra,24.11619945750453,84.93295804701627,347,JHARKHAND,Chatra,1042886,533935,508951,510061,303902,206159,340553,172668,167885,45563,23141,22422,397690,251213,146477,195502,202188,645196,119297,188513,14210,75670,903179,116710,6565,888,35,129,12936,2444,95.0,49.0
Jharkhand,Deoghar,24.33070100755672,86.75697632241814,350,JHARKHAND,Deoghar,1492073,775022,717051,793538,489837,303701,190036,98295,91741,180962,91012,89950,551467,383691,167776,297146,254321,940606,128656,209693,39361,173757,1165140,302626,6027,143,188,282,16067,1600,93.0,53.0
Jharkhand,Dhanbad,23.854509090909097,86.40372924901185,354,JHARKHAND,Dhanbad,2684487,1405956,1278531,1722204,1014950,707254,437309,226362,210947,233119,117256,115863,844504,658851,185653,546714,297790,1839983,97118,103488,25889,618009,2149480,431762,11243,9727,331,1268,77182,3494,91.0,64.0
Jharkhand,Dumka,24.275006125574265,87.27662450229711,362,JHARKHAND,Dumka,1321442,668514,652928,672409,406275,266134,79614,40802,38812,571077,282125,288952,624779,367108,257671,237479,387300,696663,193402,303084,23106,105187,1044726,106865,86404,234,267,162,78622,4162,98.0,51.0
Jharkhand,Garhwa,24.082114689265527,83.68664265536722,346,JHARKHAND,Garhwa,1322784,683575,639209,653476,405161,248315,319946,165313,154633,205874,104499,101375,571431,335451,235980,175126,396305,751353,113561,328673,14487,114710,1104475,194680,17168,123,371,20,4591,1356,94.0,49.0
Jharkhand,Giridih,24.30578509874329,86.08710915619386,349,JHARKHAND,Giridih,2445474,1258098,1187376,1253475,783736,469739,325493,166447,159046,238188,120646,117542,1036277,623946,412331,412912,623365,1409197,369913,362610,32544,271210,1856202,508586,14645,937,650,1503,59218,3733,94.0,51.0
Jharkhand,Godda,24.8189,87.2941735483871,351,JHARKHAND,Godda,1313551,677927,635624,604519,376212,228307,115567,59835,55732,279208,138510,140698,552191,344019,208172,235735,316456,761360,144603,307767,18719,81102,937126,289182,37795,97,128,115,47067,2041,94.0,46.0
Jharkhand,Gumla,23.078532948929148,84.55056787479396,366,JHARKHAND,Gumla,1025213,514390,510823,559720,321795,237925,32459,16446,16013,706754,352514,354240,487508,264774,222734,278931,208577,537705,321272,97918,12771,55547,309563,51429,202449,221,531,23,457468,3529,99.0,55.0
Jharkhand,Jamtara,23.97873318077801,86.95325080091534,363,JHARKHAND,Jamtara,791042,404830,386212,426312,258260,168052,72885,37212,35673,240489,120035,120454,326631,214740,111891,122434,204197,464411,106008,135667,11547,73409,550560,164406,4419,520,118,783,68564,1672,95.0,54.0
Jharkhand,Latehar,23.72511185840708,84.48298743362837,359,JHARKHAND,Latehar,726978,369666,357312,350682,209706,140976,154910,78266,76644,331096,166427,164669,313379,180106,133273,117311,196068,413599,103693,142729,9205,57752,473049,69808,47653,120,128,16,133525,2679,97.0,48.0
Jharkhand,Lohardaga,23.488796043165483,84.6605169064748,356,JHARKHAND,Lohardaga,461790,232629,229161,259707,149568,110139,15330,7862,7468,262734,130814,131920,221332,121605,99727,103001,118331,240458,99780,80840,4449,36263,112378,95012,16770,51,33,15,235987,1544,99.0,56.0
Jharkhand,Pakur,24.57260428082189,87.69691969178076,353,JHARKHAND,Pakur,900422,452661,447761,352881,206989,145892,28469,14352,14117,379054,186967,192087,404584,234012,170572,252017,152567,495838,105334,150028,19471,129751,410127,322963,75865,356,283,222,88760,1846,99.0,39.0
Jharkhand,Palamu,24.196925968109337,84.20310842824594,358,JHARKHAND,Palamu,1939869,1006302,933567,1024563,621706,402857,536382,277119,259263,181208,92577,88631,713175,473042,240133,283702,429473,1226694,133585,380976,19911,178703,1683169,238295,6164,734,188,284,5681,5354,93.0,53.0
Jharkhand,Ranchi,23.184235061391547,85.31781937244203,364,JHARKHAND,Ranchi,2914253,1494937,1419316,1911433,1085244,826189,152943,78613,74330,1042016,520582,521434,1142867,743967,398900,756176,386691,1771386,317487,267360,38452,519568,1612239,410759,193974,4826,932,2733,677445,11345,95.0,66.0
Jharkhand,Sahibganj,24.93667989690721,87.68264097938142,352,JHARKHAND,Sahibganj,1150567,589391,561176,483263,287303,195960,72341,37317,35024,308343,153435,154908,490202,295690,194512,322572,167630,660365,109975,206902,43179,130146,628044,398243,83208,198,245,125,38426,2078,95.0,42.0
Jharkhand,Simdega,22.608760391198054,84.59193691931536,367,JHARKHAND,Simdega,599578,300309,299269,343483,191991,151492,44674,22150,22524,424407,211546,212861,288645,159867,128778,155510,133135,310933,158019,90232,8011,32383,201524,15103,306601,51,753,114,73930,1502,100.0,57.0
Karnataka,Bagalkot,16.15860676328503,75.64526070853468,556,KARNATAKA,Bagalkot,1889752,950111,939641,1113412,641388,472024,319149,158135,161014,97203,48470,48733,818081,511575,306506,676407,141674,1071671,196199,303243,44797,273842,1634229,219991,3433,443,412,25198,166,5880,99.0,59.0
Karnataka,Bangalore Rural,12.936827087794448,77.47369314775169,583,KARNATAKA,Bangalore Rural,990923,509172,481751,688749,385311,303438,213700,107424,106276,52903,27147,25756,459891,315499,144392,389989,69902,531032,127770,84108,19457,228556,890429,92252,5368,389,272,1045,85,1083,95.0,70.0
Karnataka,Belgaum,16.16107219152853,74.72329042357275,555,KARNATAKA,Belgaum,4779661,2423063,2356598,3052032,1725548,1326484,577418,289096,288322,297198,148673,148525,2105668,1372422,733246,1734501,371167,2673993,711980,649517,60342,683829,4038331,528412,18418,2037,1086,178310,149,12918,97.0,64.0
Karnataka,Bellary,15.074377548209377,76.47228471074374,565,KARNATAKA,Bellary,2452595,1236954,1215641,1421621,813440,608181,517409,258582,258827,451406,225451,225955,1116880,703258,413622,969388,147492,1335715,258080,406092,22832,429876,2103633,320834,14014,1029,284,8044,54,4703,98.0,58.0
Karnataka,Bidar,17.950361730769224,77.19459961538459,558,KARNATAKA,Bidar,1703300,870665,832635,1042673,597198,445475,399785,204280,195505,235822,119787,116035,702608,459050,243558,551763,150845,1000692,141302,280091,18095,263120,1289709,335184,35438,1145,30453,680,521,10170,96.0,61.0
Karnataka,Bijapur,16.84015316666667,75.95909166666665,417,CHHATTISGARH,Bijapur,255230,128663,126567,86919,54076,32843,10122,5145,4977,204189,101519,102670,134525,71591,62934,69338,65187,120705,66504,49859,1399,16763,245151,1617,2709,68,1649,15,3793,228,98.0,34.0
Karnataka,Bijapur,16.84015316666667,75.95909166666665,557,KARNATAKA,Bijapur,2177331,1111022,1066309,1248268,730566,517702,442773,226440,216333,39314,19912,19402,927722,580111,347611,760083,167639,1249609,262217,351600,25379,288526,1786830,369588,2433,558,374,8665,499,8384,96.0,57.0
Karnataka,Chikmagalur,13.425288289676422,75.67626502311249,570,KARNATAKA,Chikmagalur,1137961,566622,571339,818345,438257,380088,253651,125016,128635,44970,21990,22980,565774,357889,207885,480229,85545,572187,155392,126600,8873,274909,1004553,101235,26000,182,109,4710,4,1168,101.0,72.0
Karnataka,Chitradurga,14.29102220394736,76.57821957236843,566,KARNATAKA,Chitradurga,1659456,840843,818613,1087392,607188,480204,389117,196819,192298,302554,152939,149615,856587,513311,343276,667479,189108,802869,286245,294337,26235,249770,1520553,128751,3175,322,84,3778,128,2665,97.0,66.0
Karnataka,Davanagere,14.330414586709884,75.91723841166937,567,KARNATAKA,Davanagere,1945497,986400,959097,1308540,720637,587903,392595,198299,194296,233112,117808,115304,875207,585639,289568,705099,170108,1070290,230846,295873,31438,317050,1658465,265805,5420,307,164,6417,1743,7176,97.0,67.0
Karnataka,Dharwad,15.343831376975173,75.13831264108359,562,KARNATAKA,Dharwad,1847023,937206,909817,1301664,711776,589888,177855,89137,88718,87548,44173,43375,784833,543776,241057,690948,93885,1062190,164279,207642,16463,396449,1390020,386834,28747,1486,715,29037,2748,7436,97.0,70.0
Karnataka,Gadag,15.507128256880746,75.64861302752298,561,KARNATAKA,Gadag,1064570,537147,527423,700177,397178,302999,174196,87745,86451,61654,30975,30679,495722,310412,185310,423451,72271,568848,127441,200310,15485,152486,907750,143665,3432,231,79,5993,74,3346,98.0,66.0
Karnataka,Gulbarga,17.070459515951594,76.87503850385033,579,KARNATAKA,Gulbarga,2566326,1301755,1264571,1427368,828359,599009,648782,330091,318691,65259,32830,32429,1087028,680001,407027,844237,242791,1479298,220198,415267,25891,425672,2011014,513125,8344,826,9589,4865,330,18233,97.0,56.0
Karnataka,Hassan,12.945098749999998,76.11049549999997,574,KARNATAKA,Hassan,1776421,883667,892754,1225256,668836,556420,345031,169961,175070,32329,15986,16343,903580,560452,343128,752387,151193,872841,437034,165910,16126,284510,1630814,120011,15611,289,623,5820,3,3250,101.0,69.0
Karnataka,Haveri,14.737582809224318,75.3961230607966,564,KARNATAKA,Haveri,1597668,819128,778540,1085443,603793,481650,219976,112212,107764,141380,72109,69271,730066,490731,239335,601951,128115,867602,203055,311263,20217,195531,1281878,297927,2406,419,68,9834,702,4434,95.0,68.0
Karnataka,Kodagu,12.39684468085106,75.79336595744688,576,KARNATAKA,Kodagu,554519,274608,279911,412877,215302,197575,73584,35759,37825,58054,28510,29544,278938,172100,106838,258753,20185,275581,21174,15153,1549,241062,448986,87274,17130,139,126,250,220,394,102.0,74.0
Karnataka,Kolar,13.312799881235172,78.01376947743476,581,KARNATAKA,Kolar,1536401,776396,760005,1016219,564110,452109,465867,232546,233321,78875,39997,38878,717872,454048,263824,584590,133282,818529,183057,201233,24178,309404,1305431,199873,26722,253,150,2494,92,1386,98.0,66.0
Karnataka,Koppal,15.651253271028034,76.1617048598131,560,KARNATAKA,Koppal,1389920,699926,689994,809085,468785,340300,258608,129341,129267,164271,82761,81510,654766,387974,266792,508089,146677,735154,163413,273016,18794,199543,1218024,161770,4081,296,85,2898,461,2305,99.0,58.0
Karnataka,Mandya,12.574901806239744,76.81570098522172,573,KARNATAKA,Mandya,1805769,905085,900684,1149649,638668,510981,265294,131675,133619,22402,11310,11092,871408,575203,296205,714901,156507,934361,388981,216159,17834,248434,1712695,77801,8506,322,299,3607,109,2430,100.0,64.0
Karnataka,Mysore,12.248100259403367,76.52881802853437,577,KARNATAKA,Mysore,3001127,1511600,1489527,1962180,1063766,898414,536643,269331,267312,334547,166697,167850,1314268,921803,392465,1082108,232160,1686859,349337,311002,28162,625767,2631985,290549,39361,1255,16194,14419,493,6871,99.0,65.0
Karnataka,Raichur,16.050795353982295,76.87368606194688,559,KARNATAKA,Raichur,1928812,964511,964301,979769,577213,402556,400933,200359,200574,367071,182101,184970,903413,530373,373040,725985,177428,1025399,245299,383526,19095,255493,1634062,272022,10394,538,2265,4156,29,5346,100.0,51.0
Karnataka,Shimoga,14.063845885634592,75.17882078103197,568,KARNATAKA,Shimoga,1752753,877415,875338,1263016,674938,588078,308158,153546,154612,65412,32707,32705,780598,534487,246111,652789,127809,972155,204493,246464,15087,314554,1479424,234664,26521,400,120,9234,367,2023,100.0,72.0
Karnataka,Tumkur,13.592467760074973,77.02297966260545,571,KARNATAKA,Tumkur,2678980,1350594,1328386,1813391,1006024,807367,506901,254535,252366,209559,105265,104294,1354646,837512,517134,1078431,276215,1324334,505910,352286,54523,441927,2413812,245923,9130,477,187,5067,161,4223,98.0,68.0
Karnataka,Udupi,13.450404228534568,74.72009990316337,569,KARNATAKA,Udupi,1177361,562131,615230,926429,465704,460725,75429,36988,38441,52897,26228,26669,513241,335399,177842,459446,53795,664120,63143,63390,10580,376128,1009179,96740,65838,232,161,4534,155,522,109.0,79.0
Kerala,Alappuzha,9.542602965599087,76.38010796263319,598,KERALA,Alappuzha,2127789,1013142,1114647,1852797,890552,962245,201211,97183,104028,6574,3175,3399,804471,536738,267733,596387,208084,1323318,25237,71706,35865,671663,1460447,224545,435056,268,146,74,311,6942,110.0,87.0
Kerala,Ernakulam,10.004879301987431,76.26957729035381,595,KERALA,Ernakulam,3282388,1619557,1662831,2855676,1425723,1429953,268411,131573,136838,16559,8349,8210,1249343,913249,336094,1061388,187955,2033045,50423,71391,23976,1103553,1509557,514397,1248137,860,614,1176,1083,6564,103.0,87.0
Kerala,Idukki,9.80480963855423,77.04586641566264,596,KERALA,Idukki,1108974,552808,556166,923010,471881,451129,145486,72399,73087,55815,27995,27820,516363,331710,184653,415947,100416,592611,100917,145698,6888,262860,541854,82206,481507,100,189,44,384,2690,101.0,83.0
Kerala,Kannur,11.941523076923056,75.35209891725934,589,KERALA,Kannur,2523003,1181446,1341557,2138434,1012956,1125478,83350,40260,43090,41371,20141,21230,824116,609377,214739,694209,129907,1698887,36549,82988,12875,691704,1509592,742483,262526,424,1118,193,722,5945,114.0,85.0
Kerala,Kasaragod,12.33310309912974,75.07768497134369,588,KERALA,Kasaragod,1307375,628613,678762,1037492,516476,521016,53283,26385,26898,48857,23950,24907,462998,325095,137903,372700,90298,844377,23732,38774,24496,375996,729987,486913,87454,151,362,130,152,2226,108.0,79.0
Kerala,Kollam,8.929388820570157,76.6360775852431,600,KERALA,Kollam,2635375,1246968,1388407,2240273,1074345,1165928,328263,157801,170462,10761,5195,5566,912025,644362,267663,695299,216726,1723350,56693,92193,21511,741628,1697635,508500,421598,208,272,63,619,6480,111.0,85.0
Kerala,Kottayam,9.643701174068417,76.46059673302705,597,KERALA,Kottayam,1974551,968289,1006262,1749798,861592,888206,153909,75503,78406,21972,10974,10998,735735,530322,205413,604553,131182,1238816,49991,63052,18523,604169,983598,126499,858608,204,358,83,565,4636,104.0,89.0
Kerala,Kozhikode,11.392924270557026,75.71158720159153,591,KERALA,Kozhikode,3086293,1470942,1615351,2615443,1266939,1348504,199191,97279,101912,15228,7429,7799,948981,752333,196648,754187,194794,2137312,26543,64198,13312,844928,1734958,1211131,131516,297,235,601,588,6967,110.0,85.0
Kerala,Malappuram,10.97329875666072,75.93910775606876,592,KERALA,Malappuram,4112920,1960328,2152592,3311315,1597404,1713911,308266,151557,156709,22990,11272,11718,1062424,898157,164267,852047,210377,3050496,57567,117405,18423,869029,1135259,2888849,81556,205,179,68,579,6225,110.0,81.0
Kerala,Palakkad,10.784926903553291,76.49980490693744,593,KERALA,Palakkad,2809934,1359478,1450456,2239492,1122600,1116892,403833,197451,206382,48972,24314,24658,1042340,746121,296219,875540,166800,1767594,67805,249949,25035,699551,1875980,812936,114397,220,238,78,400,5685,107.0,80.0
Kerala,Thiruvananthapuram,8.537101759082221,76.88711502868073,601,KERALA,Thiruvananthapuram,3301427,1581678,1719749,2785408,1354857,1430551,372977,178589,194388,26759,12624,14135,1231669,864101,367568,921282,310387,2069758,38837,94470,28587,1069775,2194057,452915,630573,404,301,76,1082,22019,109.0,84.0
Kerala,Thrissur,10.458932647907687,76.12321940836945,594,KERALA,Thrissur,3121200,1480763,1640437,2678548,1282261,1396287,324350,156480,167870,9430,4362,5068,1095727,789511,306216,929506,166221,2025473,41786,73941,27883,952117,1823442,532839,757484,259,278,62,585,6251,111.0,86.0
Kerala,Wayanad,11.715277464788736,76.07587007042254,590,KERALA,Wayanad,817420,401684,415736,645585,328136,317449,32578,16406,16172,151443,74476,76967,340077,228639,111438,263445,76632,477343,52759,101630,4574,181114,404460,234185,174453,61,312,1797,286,1866,103.0,79.0
Madhya Pradesh,Anuppur,23.18184220430107,81.86560000000007,461,MADHYA PRADESH,Anuppur,749237,379114,370123,436595,254120,182475,74385,37841,36544,358543,177977,180566,346471,207401,139070,227040,119431,402766,115448,130376,7051,93596,686524,21473,2132,606,86,1653,35434,1329,98.0,58.0
Madhya Pradesh,Ashoknagar,24.63098846153845,77.82974493927134,459,MADHYA PRADESH,Ashoknagar,845071,443837,401234,469109,290304,178805,175764,92216,83548,82072,42447,39625,315270,231829,83441,241288,73982,529801,116913,122387,10559,65411,778214,40707,635,8009,1352,15094,27,1033,90.0,56.0
Madhya Pradesh,Balaghat,21.80020720640569,80.42170053380796,457,MADHYA PRADESH,Balaghat,1701698,842178,859520,1147623,626468,521155,125426,61576,63850,383026,186979,196047,893014,488610,404404,530506,362508,808684,257785,459796,19245,156188,1519384,38542,5295,1050,72162,4778,58064,2423,102.0,67.0
Madhya Pradesh,Barwani,21.702135714285724,74.91004719710673,441,MADHYA PRADESH,Barwani,1385881,699340,686541,549926,313642,236284,87991,44478,43513,962145,482182,479963,653897,365928,287969,525791,128106,731984,287704,267196,7451,91546,1318869,58222,2967,2361,416,2289,263,494,98.0,40.0
Madhya Pradesh,Betul,21.964626315789477,77.7873428189117,447,MADHYA PRADESH,Betul,1575362,799236,776126,939769,529783,409986,159296,81621,77675,667018,333166,333852,786980,453887,333093,511287,275693,788382,253602,358157,11849,163372,1505745,37590,3271,1078,9651,3759,13048,1220,97.0,60.0
Madhya Pradesh,Bhind,26.35951126187245,78.7618324287653,420,MADHYA PRADESH,Bhind,1703005,926843,776162,1094917,676513,418404,374799,204212,170587,6131,3283,2848,520768,455775,64993,422111,98657,1182237,231185,158266,9838,121479,1595400,66776,973,4047,12215,19950,73,3571,84.0,64.0
Madhya Pradesh,Bhopal,23.480726143790854,77.39246623093679,444,MADHYA PRADESH,Bhopal,2371061,1236130,1134931,1660690,920314,740376,357516,185902,171614,69429,35966,33463,867457,644960,222497,706036,161421,1503604,73346,105195,24732,664184,1755861,525434,23432,10789,21688,25950,335,7572,92.0,70.0
Madhya Pradesh,Burhanpur,21.364567254408065,76.24460478589425,467,MADHYA PRADESH,Burhanpur,757847,388504,369343,408679,233073,175606,64254,33037,31217,230095,116420,113675,328339,211925,116414,274900,53439,429508,67799,156295,8077,96168,552526,180840,1199,1074,19883,1884,99,342,95.0,54.0
Madhya Pradesh,Chhatarpur,24.813637376460004,79.56449299191374,425,MADHYA PRADESH,Chhatarpur,1762375,936121,826254,943033,572010,371023,405313,215258,190055,73597,38081,35516,751797,481518,270279,553862,197935,1010578,302228,238364,26390,184815,1676918,70351,1980,968,250,10409,102,1397,88.0,54.0
Madhya Pradesh,Chhindwara,22.227966971713823,78.76413136439254,455,MADHYA PRADESH,Chhindwara,2090922,1064468,1026454,1294198,731294,562904,232244,118465,113779,769778,385785,383993,957984,582263,375721,673845,284139,1132938,283111,422668,14585,237620,1923920,100692,4893,2258,24471,7830,25771,1087,96.0,62.0
Madhya Pradesh,Damoh,23.76624407960196,79.47049303482588,428,MADHYA PRADESH,Damoh,1264219,661873,602346,747715,445737,301978,246337,129877,116460,166295,84809,81486,574595,367711,206884,389993,184602,689624,114611,250165,67383,142436,1186420,47966,1681,1096,119,25005,82,1850,91.0,59.0
Madhya Pradesh,Datia,25.90226439560441,78.63916571428574,422,MADHYA PRADESH,Datia,786754,420157,366597,491445,303815,187630,200270,107132,93138,15061,7870,7191,321160,225662,95498,247229,73931,465594,152903,93744,6839,67674,747693,28483,683,490,7923,453,10,1019,87.0,62.0
Madhya Pradesh,Dewas,22.7851110021322,76.46088805970157,437,MADHYA PRADESH,Dewas,1563715,805359,758356,925369,550716,374653,292007,150260,141747,272701,139174,133527,742676,451501,291175,528526,214150,821039,260222,310606,11816,160032,1376591,174259,2355,2330,382,6497,72,1229,94.0,59.0
Madhya Pradesh,Dhar,22.572681718963157,75.1105620736698,438,MADHYA PRADESH,Dhar,2185793,1112725,1073068,1077338,638479,438859,145436,74291,71145,1222814,614619,608195,1027974,597079,430895,783019,244955,1157819,385522,437437,15830,189185,2051219,116202,2261,1607,328,12199,88,1889,96.0,49.0
Madhya Pradesh,Dindori,22.83738437047757,81.04332966714911,453,MADHYA PRADESH,Dindori,704524,351913,352611,378714,222759,155955,39782,20366,19416,455789,225699,230090,389925,203383,186542,250137,139788,314599,150084,190962,7958,40921,605435,6736,4238,260,61,687,84006,3101,100.0,54.0
Madhya Pradesh,Guna,24.49043927178156,77.2235895968791,458,MADHYA PRADESH,Guna,1241519,649362,592157,653980,400537,253443,193115,100646,92469,190819,98206,92613,514897,335454,179443,353671,161226,726622,213949,175615,12079,113254,1172248,49203,1208,3271,529,13474,52,1534,91.0,53.0
Madhya Pradesh,Gwalior,26.04074441964285,78.12782433035713,421,MADHYA PRADESH,Gwalior,2032036,1090327,941709,1357210,803114,554096,393068,210354,182714,72133,37704,34429,685311,548820,136491,559845,125466,1346725,130586,120348,22592,411785,1835299,141735,4119,24790,4361,18058,217,3457,86.0,67.0
Madhya Pradesh,Harda,22.227659781121783,77.07022571819435,448,MADHYA PRADESH,Harda,570465,294838,275627,352550,203807,148743,92865,48553,44312,159678,81446,78232,230979,156852,74127,163781,67198,339486,68019,101256,6459,55245,527462,38640,683,676,93,1573,55,1283,93.0,62.0
Madhya Pradesh,Hoshangabad,22.595268801996703,78.02168094841929,449,MADHYA PRADESH,Hoshangabad,1241350,648725,592625,810644,469199,341445,205007,107237,97770,197300,101041,96259,478082,345435,132647,361648,116434,763268,116440,181967,9982,169693,1175203,52269,4453,3127,1550,3888,107,753,91.0,65.0
Madhya Pradesh,Indore,22.680265752128648,75.9133801324502,439,MADHYA PRADESH,Indore,3276697,1699627,1577070,2309130,1289631,1019499,545239,280184,265055,217679,112687,104992,1268195,939055,329140,1137251,130944,2008502,150907,185528,43584,888176,2728225,415142,18523,25696,11496,71667,720,5228,93.0,70.0
Madhya Pradesh,Jabalpur,23.18525572327043,79.98328754716981,451,MADHYA PRADESH,Jabalpur,2463289,1277278,1186011,1756468,980307,776161,348029,179858,168171,375231,189915,185316,1005624,705970,299654,744287,261337,1457665,106882,283636,69946,545160,2159065,203652,23142,13256,4320,33728,21010,5116,93.0,71.0
Madhya Pradesh,Jhabua,22.419578015397768,74.40921616766468,464,MADHYA PRADESH,Jhabua,1025048,515023,510025,352081,214582,137499,17427,8770,8657,891818,446359,445459,515121,265489,249632,370641,144480,509927,329175,115649,5132,65165,960925,15733,38423,141,65,8871,388,502,99.0,34.0
Madhya Pradesh,Katni,23.724416229116937,80.33819665871127,450,MADHYA PRADESH,Katni,1292042,662013,630029,790773,460583,330190,155717,79369,76348,317699,159799,157900,543874,348410,195464,316144,227730,748168,112812,223902,31261,175899,1240650,37232,3158,1167,157,5342,2643,1693,95.0,61.0
Madhya Pradesh,Mandla,22.70348712446353,80.38600543633753,454,MADHYA PRADESH,Mandla,1054905,525272,529633,604962,348033,256929,48425,24652,23773,610528,299918,310610,559649,300235,259414,325159,234490,495256,148931,318909,9453,82356,849518,16558,12450,436,297,1789,170533,3324,101.0,57.0
Madhya Pradesh,Mandsaur,24.19278764044944,75.43588667736759,433,MADHYA PRADESH,Mandsaur,1340411,682851,657560,834591,502898,331693,249024,126822,122202,33092,17023,16069,679723,397714,282009,535066,144657,660688,281465,266350,8556,123352,1192588,125548,1120,849,242,19029,77,958,96.0,62.0
Madhya Pradesh,Morena,26.37313504531724,77.88447341389724,419,MADHYA PRADESH,Morena,1965970,1068417,897553,1179685,747652,432033,421519,228548,192971,17030,8947,8083,675993,525329,150664,520970,155023,1289977,304674,148222,16354,206743,1875495,76159,1092,557,3234,6681,92,2660,84.0,60.0
Madhya Pradesh,Neemuch,24.70311893333336,75.06608186666664,432,MADHYA PRADESH,Neemuch,826067,422653,403414,508834,307889,200945,111162,56400,54762,71441,36738,34703,418682,245708,172974,358500,60182,407385,175602,136330,4020,102730,741288,67324,1508,1110,224,14165,115,333,95.0,62.0
Madhya Pradesh,Panna,24.451325840092657,80.21133001158752,426,MADHYA PRADESH,Panna,1016520,533480,483040,552559,332140,220419,207990,109421,98569,170879,87697,83182,431998,275375,156623,276633,155365,584522,135445,198847,12201,85505,974748,35214,418,186,37,4734,218,965,91.0,54.0
Madhya Pradesh,Raisen,23.292518206521724,78.16305495923909,446,MADHYA PRADESH,Raisen,1331597,700358,631239,820220,479093,341127,225891,119226,106665,205006,105627,99379,517838,370366,147472,370241,147597,813759,138725,228151,17316,133646,1195235,120331,1725,2262,253,10637,190,964,90.0,62.0
Madhya Pradesh,Rajgarh,23.785499026425583,76.66431223922116,442,MADHYA PRADESH,Rajgarh,1545814,790212,755602,804245,488797,315448,295718,151260,144458,53751,27477,26274,745603,429768,315835,471773,273830,800211,285095,330820,12123,117565,1433879,106928,1243,460,121,1599,50,1534,96.0,52.0
Madhya Pradesh,Ratlam,23.503562290502792,75.14895782122909,434,MADHYA PRADESH,Ratlam,1455069,738241,716828,825880,485090,340790,198612,100629,97983,409865,206290,203575,690980,411446,279534,471139,219841,764089,218692,305946,11928,154414,1267043,151071,3996,1353,175,29353,123,1955,97.0,57.0
Madhya Pradesh,Rewa,24.861184625158856,81.57572465057183,430,MADHYA PRADESH,Rewa,2365106,1225100,1140006,1441757,845572,596185,383508,198144,185364,311985,161696,150289,991946,617184,374762,630251,361695,1373160,258321,463506,50878,219241,2268838,85414,1964,832,986,655,232,6185,93.0,61.0
Madhya Pradesh,Sagar,23.800318709677374,78.71940357771273,427,MADHYA PRADESH,Sagar,2378458,1256257,1122201,1545719,908607,637112,501630,266306,235324,221936,114771,107165,1006035,682077,323958,779093,226942,1372423,203600,378560,140458,283417,2198297,103480,5580,4146,991,62992,168,2804,89.0,65.0
Madhya Pradesh,Satna,24.62777621776502,80.75547048710598,429,MADHYA PRADESH,Satna,2228935,1157495,1071440,1371781,801051,570730,398569,205987,192582,319975,163166,156809,911349,590487,320862,612510,298839,1317586,227967,371584,46056,265742,2158623,59471,2228,1163,364,3135,1689,2262,93.0,62.0
Madhya Pradesh,Sehore,22.9297199679658,77.06780202883085,445,MADHYA PRADESH,Sehore,1311332,683743,627589,780362,469208,311154,271281,141366,129915,145512,74391,71121,586087,364559,221528,372150,213937,725245,201307,227026,9917,147837,1163607,137980,1404,640,357,6232,66,1046,92.0,60.0
Madhya Pradesh,Seoni,22.33230487804874,79.66053863928111,456,MADHYA PRADESH,Seoni,1379131,695879,683252,864194,485341,378853,130797,66830,63967,519856,258121,261735,684434,394660,289774,397575,286859,694697,173665,376404,11957,122408,1145052,79739,1857,360,7288,4982,135315,4538,98.0,63.0
Madhya Pradesh,Shahdol,23.44859864559819,81.4596831828442,460,MADHYA PRADESH,Shahdol,1066063,540021,526042,604194,348761,255433,89733,45547,44186,476008,236947,239061,493057,292402,200655,240811,252246,573006,95795,258991,14329,123942,997073,42426,2372,912,268,1737,19448,1827,97.0,57.0
Madhya Pradesh,Shajapur,23.566620317220547,76.33555181268885,436,MADHYA PRADESH,Shajapur,1512681,780520,732161,894612,543509,351103,353914,182961,170953,37836,19416,18420,717871,431857,286014,508833,209038,794810,287924,303157,8809,117981,1321003,174724,815,631,179,13755,66,1508,94.0,59.0
Madhya Pradesh,Sheopur,25.78014810996563,77.16911116838484,418,MADHYA PRADESH,Sheopur,687861,361784,326077,328025,208201,119824,108391,57838,50553,161448,82637,78811,277455,183788,93667,196189,81266,410406,106745,115261,4166,51283,638702,41396,230,6387,201,379,40,526,90.0,48.0
Madhya Pradesh,Shivpuri,25.37802451874367,77.74861600810549,423,MADHYA PRADESH,Shivpuri,1726050,919795,806255,900846,573242,327604,321515,171565,149950,227802,117111,110691,759281,481001,278280,577723,181558,966769,383340,220440,13079,142422,1648749,51200,1117,7151,3421,12171,72,2169,88.0,52.0
Madhya Pradesh,Sidhi,24.17547189952905,82.1053783359498,462,MADHYA PRADESH,Sidhi,1127033,575912,551121,600785,353030,247755,130202,66174,64028,313304,159192,154112,461760,284289,177471,275482,186278,665273,102644,262030,15654,81432,1077545,34419,511,128,92,93,12556,1689,96.0,53.0
Madhya Pradesh,Tikamgarh,25.14099852104666,78.89357064846428,424,MADHYA PRADESH,Tikamgarh,1445166,760355,684811,747940,459353,288587,361604,190666,170938,67857,34923,32934,655318,402776,252542,470432,184886,789848,305859,223852,15622,109985,1383475,44143,588,251,109,15569,39,992,90.0,52.0
Madhya Pradesh,Ujjain,23.319288862745065,75.80383717647058,435,MADHYA PRADESH,Ujjain,1986864,1016289,970575,1240990,730817,510173,523869,267235,256634,48730,24925,23805,897442,569425,328017,682115,215327,1089422,289013,302003,19678,286748,1718204,233133,4659,3241,945,24622,211,1849,96.0,62.0
Madhya Pradesh,Umaria,23.59601063063061,80.90879477477475,431,MADHYA PRADESH,Umaria,644758,330674,314084,356672,210907,145765,58147,29902,28245,300687,151988,148699,289691,175698,113993,138600,151091,355067,65369,145690,8767,69865,620515,15966,667,190,70,220,6028,1102,95.0,55.0
Madhya Pradesh,Vidisha,23.82838307984792,77.9013507604563,443,MADHYA PRADESH,Vidisha,1458875,769568,689307,862918,512344,350574,292144,154504,137640,67603,34993,32610,550402,401583,148819,397283,153119,908473,168615,228308,12408,141071,1287391,149548,1313,914,295,18490,70,854,90.0,59.0
Maharashtra,Akola,20.746310479041902,77.12122320359276,501,MAHARASHTRA,Akola,1813906,932334,881572,1411281,758977,652304,364059,186244,177815,100280,51359,48921,768154,520362,247792,691025,77129,1045752,129680,388521,9660,240293,1107809,357253,4483,1504,328033,10205,389,4230,95.0,78.0
Maharashtra,Amravati,21.16520991810736,77.67583503184723,503,MAHARASHTRA,Amravati,2888445,1480768,1407677,2251875,1207104,1044771,506374,259398,246976,404128,205834,198294,1236322,837577,398745,1061544,174778,1652123,198793,667943,20998,348588,2055177,421410,7223,2242,383891,11360,3288,3854,95.0,78.0
Maharashtra,Bhandara,21.211792649727748,80.10950199637024,506,MAHARASHTRA,Bhandara,1200334,605520,594814,899860,488709,411151,200372,100421,99951,88886,44515,44371,597305,345054,252251,413838,183467,603029,123099,312183,17169,144854,1009352,26502,2145,831,154458,1017,3555,2474,98.0,75.0
Maharashtra,Bid,18.952353340080982,75.69319706477731,523,MAHARASHTRA,Bid,2585049,1349106,1235943,1718507,987185,731322,351254,179777,171477,32722,16806,15916,1255548,727819,527729,1154708,100840,1329501,606280,373566,21093,254609,2174672,320395,2097,824,68482,8719,399,9461,92.0,66.0
Maharashtra,Buldana,20.56680611183355,76.39017880364096,500,MAHARASHTRA,Buldana,2586258,1337560,1248698,1879874,1048892,830982,470895,241445,229450,124837,64153,60684,1219641,734024,485617,1107542,112099,1366617,385447,603227,13770,217197,1845424,354236,3531,1668,364229,12242,522,4406,93.0,73.0
Maharashtra,Chandrapur,20.095609090909075,79.31556380471388,509,MAHARASHTRA,Chandrapur,2204307,1123834,1080473,1578615,872565,706050,348365,176898,171467,389441,196753,192688,1058172,648565,409607,804433,253739,1146135,220978,473983,21346,341865,1780085,92297,10701,5251,286734,3861,23188,2190,96.0,72.0
Maharashtra,Dhule,21.274018690400517,74.58719071837263,498,MAHARASHTRA,Dhule,2050862,1054031,996831,1293916,723388,570528,127571,65068,62503,647315,327034,320281,936370,570448,365922,825875,110495,1114492,239139,429536,20646,247049,1825460,187901,3653,1422,13405,12818,912,5291,95.0,63.0
Maharashtra,Gondiya,21.225008411214997,80.17522698598128,507,MAHARASHTRA,Gondiya,1322507,661554,660953,1004243,542837,461406,175961,87434,88527,214253,105944,108309,665419,383151,282268,433962,231457,657088,186509,281414,32525,164971,1153861,26157,1827,2160,125282,1568,5080,6572,100.0,76.0
Maharashtra,Hingoli,19.59525302245251,77.09239412780653,512,MAHARASHTRA,Hingoli,1177345,606294,571051,790743,450551,340192,182565,93379,89186,111954,57674,54280,569182,330903,238279,514371,54811,608163,241613,226483,8268,92818,863199,127552,992,643,176679,5278,103,2899,94.0,67.0
Maharashtra,Jalgaon,20.8828943415638,75.55140421810695,499,MAHARASHTRA,Jalgaon,4229917,2197365,2032552,2891882,1629223,1262659,389273,199427,189846,604367,310150,294217,1863571,1186472,677099,1643955,219616,2366346,384359,937174,38930,503108,3457615,560261,7091,3091,143865,27404,9662,20928,92.0,68.0
Maharashtra,Jalna,19.984612534818933,75.98473607242339,514,MAHARASHTRA,Jalna,1959046,1011473,947573,1195523,699428,496095,272266,138957,133309,42263,21988,20275,930886,545030,385856,844492,86394,1028160,418952,300937,16705,194292,1504641,274221,12542,1629,152540,9619,336,3518,94.0,61.0
Maharashtra,Kolhapur,16.44881301587301,74.12897150793648,530,MAHARASHTRA,Kolhapur,3876001,1980658,1895343,2825845,1559760,1266085,504461,253390,251071,30206,15478,14728,1704054,1125204,578850,1508563,195491,2171947,660872,266028,59932,717222,3379906,286558,15573,1570,29766,154882,1274,6472,96.0,73.0
Maharashtra,Latur,18.348687268993856,76.75812607802874,524,MAHARASHTRA,Latur,2454196,1273140,1181056,1650672,932432,718240,480913,247918,232995,57488,29872,27616,1046857,670018,376839,964177,82680,1407339,331780,416578,17663,280836,2006984,367664,2387,935,66535,6387,310,2994,93.0,67.0
Maharashtra,Nagpur,21.196556862745105,79.02166176470584,505,MAHARASHTRA,Nagpur,4653570,2384975,2268595,3673808,1959220,1714588,867713,439205,428508,437571,223566,214005,1868560,1334211,534349,1654778,213782,2785010,206606,423587,52419,1185948,3492202,390974,34667,20469,668050,24528,12181,10499,95.0,79.0
Maharashtra,Nanded,19.209316983017,77.6829048951049,511,MAHARASHTRA,Nanded,3361292,1730075,1631217,2189425,1255222,934203,640483,328797,311686,281695,143892,137803,1493953,925232,568721,1317791,176162,1867339,447823,632395,29158,384577,2501741,471951,3902,13540,354189,5049,1273,9647,94.0,65.0
Maharashtra,Nandurbar,21.523175625248147,74.32638757443429,497,MAHARASHTRA,Nandurbar,1648295,833170,815125,906509,512099,394410,47985,24273,23712,1141933,568026,573907,792065,442898,349167,664193,127872,856230,211672,438176,14599,127618,1521618,96182,8467,685,4969,6191,2907,7276,98.0,55.0
Maharashtra,Nashik,20.266912871287143,74.03824168316828,516,MAHARASHTRA,Nashik,6107187,3157186,2950001,4345366,2397538,1947828,554687,282213,272474,1564369,792547,771822,2763328,1746286,1017042,2523023,240305,3343859,967385,730228,56132,1009583,5237009,693052,23946,8912,94783,38212,1795,9478,93.0,71.0
Maharashtra,Osmanabad,18.19459456066944,75.99495575313809,525,MAHARASHTRA,Osmanabad,1657576,861535,796041,1137810,644304,493506,265184,136354,128830,36039,18569,17470,773916,473795,300121,701894,72022,883660,297361,299525,19831,157199,1437623,178925,942,340,28216,4530,195,6805,92.0,69.0
Maharashtra,Parbhani,19.31032425249168,76.70163338870431,513,MAHARASHTRA,Parbhani,1836086,942870,893216,1157814,666291,491523,247308,125883,121425,40514,20570,19944,822797,501422,321375,756417,66380,1013289,295030,317806,13210,196751,1328385,306364,2081,1371,187899,6238,262,3486,95.0,63.0
Maharashtra,Pune,18.51696171428573,74.12922881632647,521,MAHARASHTRA,Pune,9429408,4924105,4505303,7171723,3940210,3231513,1180703,602755,577948,348876,179132,169744,4048993,2809816,1239177,3751221,297772,5380415,886530,414461,105711,2642291,8090254,673704,134192,27090,340404,127786,9873,26105,91.0,76.0
Maharashtra,Ratnagiri,17.210195070127703,73.25725893866404,528,MAHARASHTRA,Ratnagiri,1615069,761121,853948,1199392,619012,580380,66948,31967,34981,20374,10402,9972,714076,407008,307068,554973,159103,900993,296913,153117,17230,246816,1307211,187197,1990,230,113467,3347,95,1532,112.0,74.0
Maharashtra,Sangli,17.154930181086502,74.70713822937628,531,MAHARASHTRA,Sangli,2822143,1435728,1386415,2049467,1121550,927917,353093,177108,175985,18333,9406,8927,1215104,800214,414890,1074948,140156,1607039,480554,290693,40824,403033,2440312,239607,9098,1260,38210,87453,769,5434,97.0,73.0
Maharashtra,Satara,17.6737908974359,74.18052064102558,527,MAHARASHTRA,Satara,3003741,1510842,1492899,2225694,1201034,1024660,323236,161703,161533,29635,15210,14425,1354947,844805,510142,1184407,170540,1648794,585876,297241,39772,432058,2691952,146970,4408,1182,141315,12810,676,4428,99.0,74.0
Maharashtra,Sindhudurg,16.170948049777163,73.51329008172343,529,MAHARASHTRA,Sindhudurg,849651,417332,432319,666067,348289,317778,55586,26830,28756,6976,3575,3401,347178,229676,117502,226538,120640,502473,124812,81816,9679,130871,780384,26264,15471,219,24762,1046,53,1452,104.0,78.0
Maharashtra,Solapur,17.837357937584812,75.42394823609216,526,MAHARASHTRA,Solapur,4317756,2227852,2089904,2910676,1651266,1259410,649745,331960,317785,77592,39785,37807,1898395,1206933,691462,1763175,135220,2419361,637250,558334,71106,631705,3795424,441254,9882,1279,35497,28134,568,5718,94.0,67.0
Maharashtra,Thane,19.698767747440264,72.79882742564581,517,MAHARASHTRA,Thane,11060148,5865078,5195070,8227161,4591396,3635765,730089,377885,352204,1542451,769192,773259,4492767,3363123,1129644,3930511,562256,6567381,349931,418004,124461,3600371,8716055,1355630,280700,39149,449617,172052,9862,37083,89.0,74.0
Maharashtra,Wardha,20.80743024390242,78.57259105691062,504,MAHARASHTRA,Wardha,1300774,668385,632389,1019458,552617,466841,188830,96569,92261,149507,76698,72809,608235,392316,215919,529623,78612,692539,132989,282170,13785,179291,1057096,53854,2696,2147,175417,5663,2254,1647,95.0,78.0
Maharashtra,Washim,20.282282394366213,77.25502394366208,502,MAHARASHTRA,Washim,1197160,620302,576858,869917,487703,382214,229462,117867,111595,80471,41403,39068,569792,340353,229439,502755,67037,627368,165598,310195,7122,86877,859949,142672,1707,518,179330,8476,381,4127,93.0,73.0
Maharashtra,Yavatmal,20.04258346738159,78.05326371760479,510,MAHARASHTRA,Yavatmal,2772348,1419965,1352383,2022574,1115980,906594,328518,167009,161509,514057,260896,253161,1355999,815475,540524,1195100,160899,1416349,333504,739718,17899,264878,2251401,239236,4567,1596,249874,11422,3745,10507,95.0,73.0
Manipur,Bishnupur,24.50712111801243,93.8246236024845,275,MANIPUR,Bishnupur,237399,118782,118617,156333,87313,69020,22113,11085,11028,3287,1625,1662,109937,62807,47130,76423,33514,127462,34358,15109,11567,48903,175102,18691,4264,56,76,16,38457,737,100.0,66.0
Manipur,Chandel,24.2635812987013,94.09443844155844,280,MANIPUR,Chandel,144182,74579,69603,90302,51053,39249,540,321,219,128280,63622,64658,76238,42615,33623,53753,22485,67944,43255,8315,3040,21628,10810,3086,129049,136,400,59,354,288,93.0,63.0
Manipur,Churachandpur,24.30309718875504,93.38671506024085,274,MANIPUR,Churachandpur,274143,138820,135323,195935,104013,91922,443,244,199,254787,126328,128459,122655,70594,52061,89779,32876,151488,64834,8282,5067,44472,12034,2886,254979,152,495,87,2333,1177,97.0,71.0
Manipur,Senapati,25.08465586034914,94.03366234413956,272,MANIPUR,Senapati,479148,247323,231825,264477,148012,116465,1000,536,464,419210,214519,204691,233622,124143,109479,185725,47897,245526,175127,30369,4978,42307,43833,1649,426819,140,2409,53,1243,3002,94.0,55.0
Manipur,Tamenglong,24.98312942238265,93.49450740072204,273,MANIPUR,Tamenglong,140651,72371,68280,85006,47403,37603,22,17,5,134626,68226,66400,70675,37237,33438,55979,14696,69976,48849,1924,1710,18192,2995,589,134760,59,425,57,1144,622,94.0,60.0
Manipur,Thoubal,24.545392553191498,93.97959893617023,276,MANIPUR,Thoubal,422168,210845,211323,269304,152617,116687,40593,20137,20456,1808,929,879,195319,109377,85942,133428,61891,226849,77331,33106,21017,63865,267146,107323,4322,106,114,24,42347,786,100.0,64.0
Manipur,Ukhrul,25.05900314960629,94.44129566929138,279,MANIPUR,Ukhrul,183998,94718,89280,129829,70148,59681,248,160,88,173606,87970,85636,87929,46533,41396,67724,20205,96069,56815,3852,2233,25029,7553,1115,174112,108,635,70,32,373,94.0,71.0
Meghalaya,East Garo Hills,25.82728228228228,90.64684924924916,294,MEGHALAYA,East Garo Hills,317917,161223,156694,192147,102513,89634,509,304,205,305180,153861,151319,126073,72262,53811,83936,42137,191844,77390,19246,2475,26962,17272,3359,289708,56,1004,38,5617,863,97.0,60.0
Meghalaya,East Khasi Hills,25.303763888888884,91.75922519841272,298,MEGHALAYA,East Khasi Hills,825922,410749,415173,578030,287270,290760,5642,2924,2718,661158,320048,341110,326786,204303,122483,289576,37210,499136,76767,40889,2966,206164,144935,14185,543394,2495,3111,303,115597,1902,101.0,70.0
Meghalaya,Jaintia Hills,25.33959557069844,92.37608160136298,299,MEGHALAYA,Jaintia Hills,395124,196285,198839,187527,87371,100156,1317,784,533,376099,185866,190233,154180,88839,65341,110617,43563,240944,50844,35766,2004,65566,12456,1646,271596,34,284,45,107559,1504,101.0,47.0
Meghalaya,South Garo Hills,25.240568578553614,90.64560349127176,295,MEGHALAYA,South Garo Hills,142334,73170,69164,82062,45003,37059,319,188,131,134237,68140,66097,53069,32826,20243,38397,14672,89265,28145,5565,1249,18110,7036,1050,132984,27,332,10,362,533,95.0,58.0
Meghalaya,West Garo Hills,25.495285185185185,90.03709947089942,293,MEGHALAYA,West Garo Hills,643291,324159,319132,358702,193438,165264,8810,4535,4275,474009,236772,237237,255693,151914,103779,188371,67322,387598,120740,39725,7643,87585,122936,106788,389956,209,3392,144,16950,2916,98.0,56.0
Meghalaya,West Khasi Hills,25.500889926739926,91.25364542124538,296,MEGHALAYA,West Khasi Hills,383461,193715,189746,230678,117307,113371,168,93,75,375097,189134,185963,163345,89694,73651,119803,43542,220116,84956,37184,2475,38730,6498,1533,366881,58,1313,38,5878,1262,98.0,60.0
Mizoram,Aizawl,23.90781335453101,92.85359459459472,283,MIZORAM,Aizawl,400309,199270,201039,340595,169547,171048,627,388,239,373542,182517,191025,174636,104643,69993,151410,23226,225673,39266,11434,3360,120576,13249,5264,379134,105,1570,76,505,406,101.0,85.0
Mizoram,Champhai,23.54166580976866,93.24221799485862,284,MIZORAM,Champhai,125745,63388,62357,100802,51440,49362,17,16,1,123466,61954,61512,60342,34129,26213,53111,7231,65403,38336,5823,980,15203,1075,699,123446,9,151,45,194,126,98.0,80.0
Mizoram,Kolasib,24.2020004347826,92.73470391304348,282,MIZORAM,Kolasib,83955,42918,41037,65895,34147,31748,84,59,25,73609,36917,36692,36672,22733,13939,29697,6975,47283,17992,5921,585,12174,4000,4426,75210,16,108,2,46,147,96.0,78.0
Mizoram,Lawngtlai,22.36102843137253,92.66964156862753,287,MIZORAM,Lawngtlai,117894,60599,57295,62861,36444,26417,146,105,41,112354,57044,55310,45566,28517,17049,38082,7484,72328,29189,3153,613,12611,1668,522,63892,52,51549,122,2,87,95.0,53.0
Mizoram,Lunglei,23.007717036172675,92.63512555425892,286,MIZORAM,Lunglei,161428,82891,78537,121122,64515,56607,178,125,53,153533,77180,76353,78292,46230,32062,62013,16279,83136,45439,10662,813,21378,5231,1290,127124,74,27543,93,5,68,95.0,75.0
Mizoram,Mamit,23.73852942502819,92.4330803833147,281,MIZORAM,Mamit,86364,44828,41536,60191,32977,27214,51,42,9,82080,42075,40005,39339,24016,15323,36185,3154,47025,28669,2553,262,7855,2989,1782,69104,13,12328,25,19,104,93.0,70.0
Mizoram,Saiha,22.35744801061008,93.02827931034489,288,MIZORAM,Saiha,56574,28594,27980,42233,21861,20372,83,52,31,54642,27226,27416,19461,12211,7250,14694,4767,37113,8908,957,313,9283,933,514,54977,11,102,4,2,31,98.0,75.0
Mizoram,Serchhip,23.263864705882344,92.914158496732,285,MIZORAM,Serchhip,64937,32851,32086,54476,27598,26878,32,20,12,62889,31381,31508,32397,18261,14136,29838,2559,32540,21804,1284,926,8383,991,335,63444,6,60,9,35,57,98.0,84.0
Nagaland,Dimapur,25.814176811594223,93.75074057971014,265,NAGALAND,Dimapur,378811,197394,181417,278037,150142,127895,0,0,0,223989,110892,113097,151350,99645,51705,122358,28992,227461,24517,8990,5073,112770,108900,31212,234239,566,1270,2148,157,319,92.0,73.0
Nagaland,Kohima,25.60311428571428,93.78600657596373,270,NAGALAND,Kohima,267988,138966,129022,197489,107038,90451,0,0,0,224738,110617,114121,114825,68140,46685,99408,15417,153163,44684,2198,2072,65871,25496,4384,234955,998,1519,80,335,221,93.0,74.0
Nagaland,Mokokchung,26.478911764705888,94.522426006192,262,NAGALAND,Mokokchung,194622,101092,93530,159494,83479,76015,0,0,0,178431,90567,87864,100067,57084,42983,81046,19021,94555,48925,9166,3798,38178,9840,2057,181847,78,442,66,6,286,93.0,82.0
Nagaland,Mon,26.69207374301676,95.03072988826828,261,NAGALAND,Mon,250260,131753,118507,119626,67432,52194,0,0,0,238285,124343,113942,147654,79425,68229,104981,42673,102606,113473,10836,1608,21737,8102,3444,236494,84,1256,314,1,565,90.0,48.0
Nagaland,Phek,25.63272986577182,94.56814563758392,266,NAGALAND,Phek,163418,83743,79675,105893,57926,47967,0,0,0,157146,79536,77610,80277,41556,38721,63645,16632,83141,55091,3159,1275,20752,3563,950,158224,31,350,17,198,85,95.0,65.0
Nagaland,Tuensang,26.21104453280316,94.85809880715708,267,NAGALAND,Tuensang,196596,101933,94663,117511,63653,53858,0,0,0,190916,98212,92704,98154,52931,45223,73518,24636,98442,75212,3913,1104,17925,2979,1052,191864,27,572,5,1,96,93.0,60.0
Nagaland,Wokha,26.202611551155112,94.1990815181518,264,NAGALAND,Wokha,166343,84505,81838,128208,67385,60823,0,0,0,156621,78816,77805,78412,42096,36316,63512,14900,87931,47473,6438,1965,22536,5605,2043,158236,34,318,8,20,79,97.0,77.0
Nagaland,Zunheboto,26.028178205128206,94.50026666666668,263,NAGALAND,Zunheboto,140757,71217,69540,102881,53504,49377,0,0,0,136561,68071,68490,79466,41178,38288,49382,30084,61291,44723,11955,2025,20763,2580,772,136995,39,286,6,2,77,98.0,73.0
Orissa,Baleshwar,21.48570932311624,87.08085828011933,377,ORISSA,Baleshwar,2320529,1185787,1134742,1621232,902359,718873,478586,243597,234989,275678,137748,137930,932707,684020,248687,618064,314643,1387822,288818,358214,28736,256939,2197709,94254,6434,237,111,201,18345,3238,96.0,70.0
Orissa,Bhadrak,20.95262735257214,86.81496204516931,378,ORISSA,Bhadrak,1506337,760260,746077,1094140,596269,497871,334896,168687,166209,30428,15361,15067,468599,409559,59040,328097,140502,1037738,155956,151377,14451,146815,1398543,104202,745,169,81,111,61,2425,98.0,73.0
Orissa,Cuttack,20.407640646029623,85.7776810228802,381,ORISSA,Cuttack,2624470,1352760,1271710,2011469,1103033,908436,498633,254456,244177,93745,47437,46308,936365,761876,174489,696274,240091,1688105,138698,248298,51809,497560,2457729,141263,11985,1026,6276,1180,168,4843,94.0,77.0
Orissa,Dhenkanal,20.79887159353349,85.53226836027711,383,ORISSA,Dhenkanal,1192811,612593,580218,829910,464093,365817,234079,118755,115324,162056,80878,81178,435533,340552,94981,277338,158195,757278,71230,163636,17312,183355,1185542,4805,727,124,366,39,139,1069,95.0,70.0
Orissa,Gajapati,19.121080882352945,84.14015091911759,389,ORISSA,Gajapati,577817,282882,294935,262537,153663,108874,39175,19037,20138,313714,151902,161812,293933,155907,138026,170371,123562,283884,65062,153199,5370,70302,353160,1556,219482,53,2180,66,4,1316,104.0,45.0
Orissa,Ganjam,19.2632617564534,84.80297710437702,388,ORISSA,Ganjam,3529031,1779218,1749813,2210050,1262652,947398,688235,342111,346124,118928,59172,59756,1501772,990027,511745,900744,601028,2027259,284943,565448,56274,595107,3486059,13315,23975,590,174,170,76,4672,98.0,63.0
Orissa,Jharsuguda,21.827058566978184,83.93581682242987,371,ORISSA,Jharsuguda,579505,296690,282815,405879,228092,177787,104620,52580,52040,176758,88273,88485,247707,172018,75689,172069,75638,331798,40867,56809,15836,134195,553587,12783,10462,1441,80,70,67,1015,95.0,70.0
Orissa,Kalahandi,19.784253092783523,83.1124043814433,395,ORISSA,Kalahandi,1576869,787101,789768,802036,484177,317859,286580,142133,144447,449456,221171,228285,751930,447290,304640,376757,375173,824939,144991,436733,18453,151753,1555367,4975,11160,796,175,1225,220,2951,100.0,51.0
Orissa,Kandhamal,20.092878624813142,84.02216352765326,390,ORISSA,Kandhamal,733110,359945,373165,399786,233900,165886,115544,56987,58557,392820,190506,202314,355349,193515,161834,167112,188237,377761,79221,162932,11946,101250,580300,2138,148895,82,290,47,23,1335,104.0,55.0
Orissa,Kendrapara,20.606319815982264,86.83763247572003,379,ORISSA,Kendrapara,1440361,717814,722547,1089265,579970,509295,309780,155531,154249,9484,4748,4736,466890,386382,80508,322265,144625,973471,149264,143864,16544,157218,1386792,50247,1423,169,62,52,24,1592,101.0,76.0
Orissa,Khordha,20.054162322274863,85.52234834123229,386,ORISSA,Khordha,2251673,1167137,1084536,1749936,957515,792421,297472,151528,145944,115051,59094,55957,792193,645880,146313,632625,159568,1459480,92662,116274,39471,543786,2147632,84060,12527,1264,475,476,434,4805,93.0,78.0
Orissa,Koraput,18.82627794779476,82.81278469846964,398,ORISSA,Koraput,1379647,678809,700838,568090,340843,227247,196540,96789,99751,697583,337373,360210,693406,384053,309353,396460,296946,686241,207194,290626,14416,181170,1294151,8850,68550,518,219,491,3384,3484,103.0,41.0
Orissa,Malkangiri,18.25227930367506,81.98293636363628,399,ORISSA,Malkangiri,613192,303624,309568,244706,147001,97705,138295,70052,68243,354614,171717,182897,310666,170495,140171,179030,131636,302526,151260,106353,7725,45328,600219,1871,10039,213,43,195,35,577,102.0,40.0
Orissa,Mayurbhanj,21.897621545157754,86.4030408052231,376,ORISSA,Mayurbhanj,2519738,1256213,1263525,1369397,794171,575226,184682,92127,92555,1479576,730487,749089,1223534,697782,525752,548390,675144,1296204,238772,568755,113808,302199,2113079,33706,15008,661,162,109,351714,5299,101.0,54.0
Orissa,Nayagarh,20.192895622119817,85.05614700460825,385,ORISSA,Nayagarh,962789,502636,460153,688362,392333,296029,136399,69813,66586,58691,29173,29518,343633,284591,59042,229076,114557,619156,83022,120129,17557,122925,955754,5278,383,107,33,24,12,1198,92.0,71.0
Orissa,Nuapada,20.471309512195116,82.59152536585364,394,ORISSA,Nuapada,610382,301962,308420,299383,180903,118480,82159,40742,41417,206327,100469,105858,305438,168155,137283,151694,153744,304944,94692,149834,8641,52271,601092,4952,1778,724,76,905,22,833,102.0,49.0
Orissa,Puri,19.83509174603177,85.86698989898981,387,ORISSA,Puri,1698730,865380,833350,1291939,704857,587082,325133,164366,160767,6129,3240,2889,621676,498461,123215,450536,171140,1077054,172761,163942,25115,259858,1644905,46094,4239,193,243,94,302,2660,96.0,76.0
Orissa,Rayagada,19.292840020060204,83.45860120361095,396,ORISSA,Rayagada,967911,471960,495951,407735,241959,165776,139514,68068,71446,541905,259040,282865,467122,258032,209090,227815,239307,500789,99265,248175,9959,109723,874445,4607,84916,219,249,123,44,3308,105.0,42.0
Orissa,Sambalpur,21.515752380952385,84.34958483245157,372,ORISSA,Sambalpur,1041099,526877,514222,703691,393192,310499,191827,96511,95316,355261,177565,177696,505840,313161,192679,336854,168986,535259,86800,160798,59288,198954,964188,20120,50637,2506,310,86,1117,2135,98.0,68.0
Orissa,Sundargarh,22.06354819277107,84.50524819277099,374,ORISSA,Sundargarh,2093437,1061147,1032290,1342322,750147,592175,191660,96465,95195,1062349,526856,535493,873227,584687,288540,535112,338115,1220210,184273,253327,26970,408657,1532352,71391,385011,5713,710,721,89986,7553,97.0,64.0
Puducherry,Karaikal,10.876161726078813,79.82369793621002,637,PONDICHERRY,Karaikal,200222,97809,102413,154916,79903,75013,35348,17206,18142,0,0,0,68301,53139,15162,58342,9959,131921,2372,13077,1327,51525,152638,28835,18391,46,63,54,14,181,105.0,77.0
Puducherry,Mahe,12.006420793787758,75.28275021570326,636,PONDICHERRY,Mahe,41816,19143,22673,36470,16610,19860,144,77,67,0,0,0,11802,9093,2709,10404,1398,30014,43,82,69,11608,27940,12856,958,3,21,14,3,21,118.0,87.0
Puducherry,Yanam,16.707695652173904,82.26187304347832,634,PONDICHERRY,Yanam,55626,27301,28325,39274,19919,19355,8427,4100,4327,0,0,0,16760,14047,2713,15373,1387,38866,291,3324,146,12999,53537,1191,873,3,1,4,4,13,104.0,71.0
Punjab,Amritsar,31.548679820627772,74.79883856502238,49,PUNJAB,Amritsar,2490656,1318408,1172248,1684770,932981,751789,770864,405977,364887,0,0,0,917856,735195,182661,787254,130602,1572800,124617,121599,41642,629998,690939,12502,54344,1716935,876,3152,1044,10864,89.0,68.0
Punjab,Bathinda,30.190524611973352,75.05685898004438,46,PUNJAB,Bathinda,1388525,743197,645328,844868,488261,356607,450473,236936,213537,0,0,0,549986,432988,116998,452678,97308,838539,141535,128382,14938,265131,380569,16299,2474,984286,246,1266,559,2826,87.0,61.0
Punjab,Faridkot,30.591187250996025,74.79751553784862,45,PUNJAB,Faridkot,617508,326671,290837,381285,215767,165518,240328,126567,113761,0,0,0,221555,185049,36506,190415,31140,395953,53230,54058,8225,106042,141363,3125,1227,469789,155,1109,103,637,89.0,62.0
Punjab,Fatehgarh Sahib,30.64290947368421,76.36208394736842,40,PUNJAB,Fatehgarh Sahib,600163,320795,279368,426033,238696,187337,192493,101882,90611,0,0,0,214783,182777,32006,192845,21938,385380,44245,21389,8048,141101,152851,16808,1698,427521,48,178,251,808,87.0,71.0
Punjab,Firozpur,30.63407535211269,74.40245732394365,43,PUNJAB,Firozpur,2029074,1071637,957437,1227511,707070,520441,855726,445461,410265,0,0,0,756695,596406,160289,618362,138333,1272379,191685,227971,14679,322360,906408,6844,19358,1090815,454,1143,278,3774,89.0,60.0
Punjab,Gurdaspur,32.04283371212125,75.3204064393939,35,PUNJAB,Gurdaspur,2298323,1212617,1085706,1634719,907660,727059,580576,304894,275682,0,0,0,757138,637652,119486,625778,131360,1541185,147912,100684,30903,477639,1074332,27667,176587,1002874,405,580,812,15066,90.0,71.0
Punjab,Hoshiarpur,31.55157169811319,75.8469857442349,38,PUNJAB,Hoshiarpur,1586625,809057,777568,1199699,637927,561772,557504,284322,273182,0,0,0,499822,412506,87316,411011,88811,1086803,89772,74362,15990,319698,1000743,23089,14968,538208,3476,2034,531,3576,96.0,76.0
Punjab,Jalandhar,31.250336907216507,75.54400350515463,37,PUNJAB,Jalandhar,2193590,1145211,1048379,1622537,882581,739956,854444,442124,412320,0,0,0,774472,639484,134988,689592,84880,1419118,85695,66664,29762,592351,1394329,30233,26016,718363,11385,4011,805,8448,92.0,74.0
Punjab,Kapurthala,31.336592638036837,75.47641165644177,36,PUNJAB,Kapurthala,815168,426311,388857,576567,316254,260313,276707,143901,132806,0,0,0,284165,235562,48603,248208,35957,531003,55252,42387,9861,176665,336124,10190,5445,453692,6662,553,334,2168,91.0,71.0
Punjab,Ludhiana,30.76596397379912,75.83110851528383,41,PUNJAB,Ludhiana,3498739,1867816,1630923,2560225,1428348,1131877,923358,487839,435519,0,0,0,1284822,1053600,231222,1138654,146168,2213917,140737,98646,71667,973772,1502403,77713,16517,1863408,2007,19620,1254,15817,87.0,73.0
Punjab,Mansa,29.919547714285724,75.4304922857143,47,PUNJAB,Mansa,769751,408732,361019,423560,244037,179523,258878,136311,122567,0,0,0,328512,230739,97773,247175,81337,441239,105963,90367,13442,118740,156539,10375,917,598443,123,1577,493,1284,88.0,55.0
Punjab,Moga,30.756540067340065,75.1600845117845,42,PUNJAB,Moga,995746,525920,469826,627889,348549,279340,363417,192418,170999,0,0,0,359172,292379,66793,304880,54292,636574,91622,82397,18098,167055,158414,9388,3277,818921,178,436,365,4767,89.0,63.0
Punjab,Muktsar,30.31243303303303,74.5518747747748,44,PUNJAB,Muktsar,901896,475622,426274,524848,300401,224447,381554,200473,181081,0,0,0,335326,272699,62627,287205,48121,566570,86565,111014,5187,132560,254920,4333,1681,638625,240,744,433,920,90.0,58.0
Punjab,Patiala,30.214540380693364,76.27505893949697,48,PUNJAB,Patiala,1895686,1002522,893164,1266791,711052,555739,465359,244503,220856,0,0,0,660267,549661,110606,570391,89876,1235419,113182,89123,23647,434315,783306,40043,5683,1059944,245,1914,1410,3141,89.0,67.0
Punjab,Rupnagar,30.910937330754347,76.53743500967126,51,PUNJAB,Rupnagar,684627,357485,327142,502731,278534,224197,180905,94334,86571,0,0,0,233676,186910,46766,194209,39467,450951,45640,21520,12321,154195,304481,14492,2094,361045,118,653,143,1601,92.0,73.0
Punjab,Sangrur,30.185045204336895,75.89437014178496,53,PUNJAB,Sangrur,1655169,878029,777140,1002077,570413,431664,461609,244231,217378,0,0,0,568758,485129,83629,499792,68966,1086411,157191,91799,18578,301190,389410,179116,2406,1077438,268,3222,1038,2271,89.0,61.0
Rajasthan,Ajmer,26.199300378787903,74.6990419191919,119,RAJASTHAN,Ajmer,2583052,1324085,1258967,1526673,926268,600405,478027,243750,234277,63482,32408,31074,1053722,686149,367573,827181,226541,1529330,298856,145523,35602,573741,2201663,314159,10605,6799,417,45614,184,3611,95.0,59.0
Rajasthan,Alwar,27.55271738035265,76.65359630562563,104,RAJASTHAN,Alwar,3674179,1939026,1735153,2182476,1359829,822647,653036,342938,310098,289249,153397,135852,1708542,994171,714371,1179461,529081,1965637,898891,216772,34562,558317,3039279,547335,2696,64532,4384,13221,348,2384,89.0,59.0
Rajasthan,Banswara,23.453642032967014,74.44246868131869,125,RAJASTHAN,Banswara,1797485,907754,889731,829343,513854,315489,80091,40639,39452,1372999,690476,682523,916574,482236,434338,542983,373591,880911,546569,199370,19818,150817,1701234,48834,22250,427,138,22613,109,1880,98.0,46.0
Rajasthan,Baran,24.98023243243244,76.86210651828291,128,RAJASTHAN,Baran,1222755,633945,588810,693307,432607,260700,221184,114969,106215,276857,143094,133763,552583,329754,222829,359785,192798,670172,216538,185037,15258,135750,1133349,79984,1432,3066,84,2795,48,1997,93.0,57.0
Rajasthan,Barmer,25.77070908045978,71.50297126436782,115,RAJASTHAN,Barmer,2603751,1369022,1234729,1188322,783461,404861,436414,228431,207983,176257,92610,83647,1202482,696240,506242,741367,461115,1401269,754260,132696,30565,284961,2244882,321192,1157,450,157,34010,34,1869,90.0,46.0
Rajasthan,Bharatpur,27.32411858037578,77.21752077244258,105,RAJASTHAN,Bharatpur,2548462,1355726,1192736,1480869,943910,536959,557305,296293,261012,54090,28705,25385,1071154,647198,423956,694929,376225,1477308,500994,238894,25068,306198,2143046,371286,1576,23456,899,5758,18,2423,88.0,58.0
Rajasthan,Bhilwara,25.45119767759564,74.63947595628417,122,RAJASTHAN,Bhilwara,2408523,1220736,1187787,1256126,777582,478544,407947,206332,201615,229273,117026,112247,1148165,674589,473576,883329,264836,1260358,555168,163052,30149,399796,2224839,142427,1978,1468,183,35149,60,2419,97.0,52.0
Rajasthan,Bikaner,28.12489068322981,73.26943322981371,101,RAJASTHAN,Bikaner,2363937,1240801,1123136,1278801,782399,496402,493646,259532,234114,7779,4207,3572,986208,640572,345636,752768,233440,1377729,499223,103833,26244,356908,2073356,235741,1901,20072,285,30850,79,1653,91.0,54.0
Rajasthan,Bundi,25.48580716049379,75.79984074074079,121,RAJASTHAN,Bundi,1110906,577160,533746,585044,371705,213339,210788,109333,101455,228549,119454,109095,526091,314806,211285,361070,165021,584815,250453,111388,11172,153078,1017688,66609,682,11059,144,13455,24,1245,92.0,53.0
Rajasthan,Chittaurgarh,24.631623761665463,74.80010997846382,126,RAJASTHAN,Chittaurgarh,1544338,783171,761167,821825,514851,306974,250224,126748,123476,201546,101893,99653,802755,456632,346123,656904,145851,741583,453201,123469,15435,210650,1413163,97855,1274,1515,252,25843,136,4300,97.0,53.0
Rajasthan,Churu,28.29330375536484,74.65846427038629,102,RAJASTHAN,Churu,2039547,1051446,988101,1149269,696729,452540,451721,235113,216608,11245,5903,5342,902829,541404,361425,628381,274448,1136718,572644,87983,16594,225608,1777879,249736,958,402,188,7104,127,3153,94.0,56.0
Rajasthan,Dausa,26.91234817629181,76.57342097264443,109,RAJASTHAN,Dausa,1634409,857787,776622,938051,596935,341116,354337,185349,168988,433344,228554,204790,684495,398151,286344,506214,178281,949914,390960,76277,17185,200073,1582335,45488,439,296,94,3737,115,1905,91.0,57.0
Rajasthan,Dhaulpur,26.72397054945053,77.74476219780222,106,RAJASTHAN,Dhaulpur,1206516,653647,552869,683098,435721,247377,245695,131875,113820,58594,31802,26792,523212,339110,184102,317617,205595,683304,229936,74342,12721,206213,1127520,72258,688,1356,92,2739,21,1842,85.0,57.0
Rajasthan,Dungarpur,23.75104807692308,73.84765641025645,124,RAJASTHAN,Dungarpur,1388552,696532,692020,681591,415820,265771,52267,26543,25724,983437,491631,491806,641515,346624,294891,216411,425104,747037,227849,184330,12514,216822,1340065,28662,830,240,226,16141,853,1535,99.0,49.0
Rajasthan,Ganganagar,29.256785412667963,73.56192303262948,99,RAJASTHAN,Ganganagar,1969168,1043340,925828,1193343,710908,482435,720412,376734,343678,13477,7160,6317,912672,596320,316352,680563,232109,1056496,268297,230438,13790,400147,1437144,50688,2077,474853,938,1988,164,1316,89.0,61.0
Rajasthan,Hanumangarh,29.1813351791531,74.74632573289902,100,RAJASTHAN,Hanumangarh,1774692,931184,843508,1034136,624281,409855,494189,258352,235837,14289,7578,6711,835260,512802,322458,642109,193151,939432,370452,166833,13839,284136,1433067,118673,1542,216997,241,1935,138,2099,91.0,58.0
Rajasthan,Jaipur,27.033459290187885,75.77117286012533,110,RAJASTHAN,Jaipur,6626178,3468507,3157671,4300965,2554793,1746172,1003302,524831,478471,527966,276638,251328,2464893,1714947,749946,2060010,404883,4161285,744374,131523,91011,1497985,5819980,687452,12708,18782,1020,81079,257,4900,91.0,65.0
Rajasthan,Jaisalmer,26.86900838548185,71.18371877346682,114,RAJASTHAN,Jaisalmer,669919,361708,308211,308653,210415,98238,99134,52776,46358,42429,22497,19932,288903,182565,106338,175383,113520,381016,132466,43872,6835,105730,497045,168129,874,1723,98,1521,34,495,85.0,46.0
Rajasthan,Jalor,25.07578093797277,72.18647261724662,116,RAJASTHAN,Jalor,1828730,936634,892096,829582,543923,285659,357196,185342,171854,178719,93290,85429,896644,494906,401738,660719,235925,932086,493355,158013,21867,223409,1732852,78990,730,231,144,14640,82,1061,95.0,45.0
Rajasthan,Jhalawar,24.24725541474657,76.11242891705065,129,RAJASTHAN,Jhalawar,1411129,725143,685986,739792,466815,272977,243582,125965,117617,182229,94185,88044,685950,402825,283125,475653,210297,725179,328714,209772,11199,136265,1299751,96164,842,819,46,12488,42,977,95.0,52.0
Rajasthan,Jhunjhunun,28.13517401247401,75.52840893970894,103,RAJASTHAN,Jhunjhunun,2137045,1095896,1041149,1370360,815834,554526,360709,185879,174830,41629,21380,20249,894649,541392,353257,592813,301836,1242396,521692,68878,13472,290607,1905682,228178,1004,275,56,548,85,1217,95.0,64.0
Rajasthan,Jodhpur,26.678460838536967,73.00450847457628,113,RAJASTHAN,Jodhpur,3687165,1923928,1763237,2031532,1265753,765779,608024,315199,292825,118924,61969,56955,1489741,965103,524638,1056479,433262,2197424,592370,242017,42412,612942,3224399,411558,6035,4123,514,36697,80,3759,92.0,55.0
Rajasthan,Karauli,26.51901555555556,76.96081818181815,107,RAJASTHAN,Karauli,1458248,783639,674609,805849,531904,273945,354465,189249,165216,324960,176200,148760,628726,371058,257668,438337,190389,829522,335302,115367,9521,168536,1370977,81553,602,297,70,3424,413,912,86.0,55.0
Rajasthan,Kota,25.175718080000014,76.18618928000001,127,RAJASTHAN,Kota,1951014,1021161,929853,1298345,765396,532949,405408,211161,194247,183816,96428,87388,748811,534650,214161,577548,171263,1202203,140262,134992,25125,448432,1661307,243993,5665,11058,280,25742,286,2683,91.0,67.0
Rajasthan,Nagaur,27.07862016048146,74.14215667001012,112,RAJASTHAN,Nagaur,3307743,1696325,1611418,1758624,1102750,655874,699911,360451,339460,10418,5475,4943,1425882,857031,568851,985927,439955,1881861,734614,263401,29647,398220,2833443,454487,1912,366,163,12940,276,4156,95.0,53.0
Rajasthan,Pali,25.80490393541874,73.55285640766907,118,RAJASTHAN,Pali,2037573,1025422,1012151,1085693,667381,418312,398096,203328,194768,144578,74369,70209,842327,523077,319250,605288,237039,1195246,243491,237280,26119,335437,1870543,143476,1345,1540,141,18974,52,1502,99.0,53.0
Rajasthan,Rajsamand,25.24894767441859,73.96570215946844,123,RAJASTHAN,Rajsamand,1156597,581339,575258,619139,383334,235805,148168,74738,73430,160809,81173,79636,550831,319534,231297,362584,188247,605766,207582,106587,13505,223157,1105676,33677,759,260,100,14966,68,1091,99.0,54.0
Rajasthan,Sawai Madhopur,26.251081180223288,76.4219283891548,108,RAJASTHAN,Sawai Madhopur,1335551,704031,631520,741748,486184,255564,278789,146333,132456,285848,152745,133103,578068,343802,234266,418555,159513,757483,313358,88804,12070,163836,1165505,155681,945,812,177,9991,42,2398,90.0,56.0
Rajasthan,Sikar,27.64644058641976,75.29317422839503,111,RAJASTHAN,Sikar,2677333,1374990,1302343,1652117,995275,656842,418806,216523,202283,75349,39098,36251,1006504,657854,348650,698711,307793,1670829,501311,87889,22776,394528,2342076,327583,1122,356,177,4050,15,1954,95.0,62.0
Rajasthan,Sirohi,24.7976905263158,72.75309131578943,117,RAJASTHAN,Sirohi,1036346,534231,502115,476806,309900,166906,201863,104899,96964,292470,148966,143504,419829,272196,147633,313292,106537,616517,124080,97823,9443,188483,996562,30479,1284,572,114,6829,56,450,94.0,46.0
Rajasthan,Tonk,26.153935071707927,75.79192216427637,120,RAJASTHAN,Tonk,1421326,728136,693190,749659,478329,271330,287903,148110,139793,178207,92677,85530,649161,371848,277313,495797,153364,772165,326083,113426,16004,193648,1243527,153146,754,378,122,22458,30,911,95.0,53.0
Rajasthan,Udaipur,24.44076752136749,73.84029839743584,130,RAJASTHAN,Udaipur,3068420,1566801,1501619,1582629,973444,609185,188525,97094,91431,1525289,773213,752076,1365783,835839,529944,822355,543428,1702637,539106,302968,33535,490174,2869976,104307,7406,4278,209,78647,373,3224,96.0,52.0
Sikkim,East,27.29600352941175,88.74908392156858,93,NCT OF DELHI,East,1709346,907500,801846,1352998,748382,604616,281422,148019,133403,0,0,0,579692,486951,92741,555026,24666,1129654,1156,3094,19541,555901,1410852,178807,15792,53027,2643,46927,366,932,88.0,79.0
Tamil Nadu,Ariyalur,11.190514836795256,79.22249643916912,616,TAMIL NADU,Ariyalur,754894,374703,380191,480604,269582,211022,176230,88076,88154,10722,5274,5448,359851,212547,147304,272241,87610,395043,107312,166837,13564,72138,708397,7942,37403,104,88,65,42,853,101.0,64.0
Tamil Nadu,Chennai,13.058098905608748,80.28139151846806,603,TAMIL NADU,Chennai,4646732,2335844,2310888,3776276,1968079,1808197,779667,389001,390666,10061,5207,4854,1817297,1369302,447995,1619554,197743,2829435,14454,13674,37345,1751824,3751322,439270,358662,2851,2804,51708,1759,38356,99.0,81.0
Tamil Nadu,Coimbatore,10.871376995940452,77.07619012178621,632,TAMIL NADU,Coimbatore,3458045,1729297,1728748,2635907,1394790,1241117,535911,266960,268951,28342,14245,14097,1567950,1083125,484825,1443252,124698,1890095,80217,230026,50085,1207622,3044145,211035,190314,1112,435,3284,237,7483,100.0,76.0
Tamil Nadu,Cuddalore,11.57587300613498,79.63002365371497,617,TAMIL NADU,Cuddalore,2605914,1311697,1294217,1815281,1000322,814959,763944,383943,380001,15702,7943,7759,1169880,749633,420247,837271,332609,1436034,165170,539412,32027,433271,2391675,123749,83334,401,236,1280,138,5101,99.0,70.0
Tamil Nadu,Dharmapuri,12.300141200000006,78.11509813333339,630,TAMIL NADU,Dharmapuri,1506843,774303,732540,917709,527599,390110,245392,124706,120686,63044,32130,30914,751170,446057,305113,652996,98174,755673,201328,267345,15341,267156,1452956,38304,14089,164,39,37,87,1167,95.0,61.0
Tamil Nadu,Dindigul,10.377801390820574,77.78011279554937,612,TAMIL NADU,Dindigul,2159775,1080938,1078837,1481834,816180,665654,452376,225573,226803,8064,4095,3969,1105155,665469,439686,963017,142138,1054620,165405,467959,30829,440962,1879494,105012,169945,313,256,71,138,4546,100.0,69.0
Tamil Nadu,Erode,11.267012155963302,77.42034334862392,610,TAMIL NADU,Erode,2251744,1129868,1121876,1492662,828300,664362,369483,184408,185075,21880,11024,10856,1195773,732083,463690,1111051,84722,1055971,178170,370212,54322,593069,2115455,76098,55899,435,148,639,157,2913,99.0,66.0
Tamil Nadu,Kancheepuram,12.496424756511884,80.08820360135913,604,TAMIL NADU,Kancheepuram,3998252,2012958,1985294,3013382,1611461,1401921,948081,474264,473817,41210,20605,20605,1673814,1181308,492506,1367378,306436,2324438,89343,272514,54732,1257225,3537399,173785,256762,1620,990,4962,756,21978,99.0,75.0
Tamil Nadu,Kanniyakumari,8.183466300191206,77.32053064053538,629,TAMIL NADU,Kanniyakumari,1870374,926345,944029,1548738,780541,768197,74249,36817,37432,7282,3554,3728,679620,524629,154991,552658,126962,1190754,15610,72867,35789,555354,909872,78590,876299,160,438,156,10,4849,102.0,83.0
Tamil Nadu,Karur,10.79532776617955,78.08749686847604,613,TAMIL NADU,Karur,1064493,528184,536309,727044,401726,325318,221385,108809,112576,575,297,278,543298,329034,214264,508507,34791,521195,85872,200837,11340,245249,993666,53292,16483,115,29,7,79,822,102.0,68.0
Tamil Nadu,Madurai,9.904313833333331,78.01366033333332,623,TAMIL NADU,Madurai,3038252,1526475,1511777,2273430,1223810,1049620,408976,205098,203878,11096,5622,5474,1354632,902704,451928,1173902,180730,1683620,92719,372828,47293,841792,2760502,168881,97711,520,199,1532,305,8602,99.0,75.0
Tamil Nadu,Nagapattinam,10.789468161718286,79.79437299431483,618,TAMIL NADU,Nagapattinam,1616450,798127,818323,1213008,640916,572092,509767,252332,257435,3756,1847,1909,671994,461174,210820,486328,185666,944456,67482,345057,11555,247900,1435072,128617,47579,184,450,963,110,3475,103.0,75.0
Tamil Nadu,Namakkal,11.33766638477801,78.14624841437633,609,TAMIL NADU,Namakkal,1726601,869280,857321,1176131,653312,522819,345392,173973,171419,57059,29383,27676,898245,531463,366782,839152,59093,828356,158473,253726,38797,447249,1673652,32483,16909,183,108,84,199,2983,99.0,68.0
Tamil Nadu,Perambalur,11.260137758112096,78.86034011799416,615,TAMIL NADU,Perambalur,565223,282157,283066,375823,208011,167812,175289,87444,87845,2584,1292,1292,299726,162639,137087,255097,44629,265497,117304,118278,5343,58801,521658,32702,10301,83,39,38,26,376,100.0,66.0
Tamil Nadu,Pudukkottai,10.130514816433578,79.05444484265728,621,TAMIL NADU,Pudukkottai,1618345,803188,815157,1110545,608776,501769,284804,141428,143376,1283,647,636,761693,471099,290594,640248,121445,856652,209270,305149,13941,233333,1428784,114194,72850,119,81,32,293,1992,101.0,69.0
Tamil Nadu,Ramanathapuram,9.31286995153476,78.99185362412462,626,TAMIL NADU,Ramanathapuram,1353445,682658,670787,978946,536487,442459,249008,125015,123993,1105,559,546,602977,392751,210226,486150,116827,750468,173767,153874,25228,250108,1047411,208038,91139,154,86,29,36,6552,98.0,72.0
Tamil Nadu,Salem,11.629324202127655,78.2478257978723,608,TAMIL NADU,Salem,3482056,1781571,1700485,2285562,1285107,1000455,580512,294062,286450,119369,60489,58880,1694160,1083797,610363,1561030,133130,1787896,257004,454210,141503,841443,3326357,95487,53841,412,174,992,246,4547,95.0,66.0
Tamil Nadu,Sivaganga,9.960306580645158,78.56535729032255,622,TAMIL NADU,Sivaganga,1339101,668672,670429,959744,526304,433440,227746,113599,114147,790,394,396,620171,391305,228866,461102,159069,718930,141003,199563,14656,264949,1186078,74310,75481,150,80,109,24,2869,100.0,72.0
Tamil Nadu,Thanjavur,10.387692255892237,79.3194869107745,620,TAMIL NADU,Thanjavur,2405890,1182416,1223474,1790998,944264,846734,455062,225859,229203,3561,1739,1822,974079,680483,293596,834484,139595,1431811,129913,415361,31200,397605,2075870,190814,133971,231,795,1256,148,2805,103.0,74.0
Tamil Nadu,Theni,9.924066666666668,77.43458833333332,624,TAMIL NADU,Theni,1245899,625683,620216,870080,479403,390677,258200,129900,128300,1835,954,881,591642,368900,222742,530591,61051,654257,38367,315161,14939,223175,1148990,56751,37574,152,79,28,74,2251,99.0,70.0
Tamil Nadu,Thiruvallur,13.275858101752885,80.19724702864492,602,TAMIL NADU,Thiruvallur,3728104,1876062,1852042,2791721,1495711,1296010,821646,410526,411120,47243,23692,23551,1538054,1103563,434491,1247918,290136,2190050,73444,270586,58240,1135784,3325823,143093,233633,1422,951,3693,530,18959,99.0,75.0
Tamil Nadu,Thiruvarur,10.368927409395978,79.60322893959727,619,TAMIL NADU,Thiruvarur,1264277,626693,637584,946471,503085,443386,430927,214717,216210,3034,1466,1568,540168,369853,170315,412425,127743,724109,69883,295188,10440,164657,1132785,96092,33192,258,151,279,64,1456,102.0,75.0
Tamil Nadu,Tiruvannamalai,12.419318947368414,79.23265631578953,606,TAMIL NADU,Tiruvannamalai,2464875,1235889,1228986,1626813,909803,717010,565329,282615,282714,90954,45956,44998,1238177,738995,499182,970072,268105,1226698,292641,525063,46720,373753,2294369,91636,66987,232,157,7898,110,3486,99.0,66.0
Tamil Nadu,Vellore,12.784882632293078,79.02643283582084,605,TAMIL NADU,Vellore,3936331,1961688,1974643,2773928,1504355,1269573,860212,424668,435544,72955,36663,36292,1689330,1123874,565456,1360185,329145,2247001,175108,391955,136415,985852,3397857,414760,111390,676,438,3514,251,7445,101.0,70.0
Tamil Nadu,Virudhunagar,9.468872195892564,77.87641469194315,625,TAMIL NADU,Virudhunagar,1942288,967709,974579,1398788,760375,638413,399831,198704,201127,2294,1182,1112,950158,579111,371047,854066,96092,992130,57153,208702,35298,649005,1822626,47838,67405,245,87,98,75,3914,101.0,72.0
Tripura,Dhalai,23.781360477941163,91.94654283088232,291,TRIPURA,Dhalai,378230,194544,183686,276217,151643,124574,61688,31461,30227,210608,106759,103849,155831,105657,50174,108259,47572,222399,45956,42201,2870,64804,307120,8256,22940,175,39120,85,206,328,94.0,73.0
Tripura,North Tripura,24.121739755351683,92.17842538226292,292,TRIPURA,North Tripura,693947,352860,341087,520402,275646,244756,114968,58375,56593,179426,91116,88310,248667,186034,62633,186105,62562,445280,49286,43977,7088,148316,507967,105737,44062,151,34717,307,70,936,97.0,75.0
Tripura,South Tripura,23.211874098057383,91.6065807585568,290,TRIPURA,South Tripura,876001,447544,428457,646810,351082,295728,140168,72012,68156,344835,173174,171661,366845,253229,113616,258457,108388,509156,85530,111332,6375,163608,736015,49258,39258,245,49420,106,808,891,96.0,74.0
Tripura,West Tripura,23.780166241299337,91.41310788863107,289,TRIPURA,West Tripura,1725739,879428,846311,1361354,722998,638356,338094,172522,165572,431944,217278,214666,698178,500406,197772,524198,173980,1027561,115175,156108,25163,401732,1512801,152791,53622,499,2128,362,430,3106,96.0,79.0
Uttar Pradesh,Agra,26.99512974910393,78.05278291517321,146,UTTAR PRADESH,Agra,4418797,2364953,2053844,2680510,1614594,1065916,991325,531641,459684,7255,3827,3428,1389844,1119701,270143,1050562,339282,3028953,285471,234455,94184,775734,3922718,411313,10076,12057,4049,21508,384,36692,87.0,61.0
Uttar Pradesh,Aligarh,27.93748576850093,78.00146831119557,143,UTTAR PRADESH,Aligarh,3673889,1951996,1721893,2092567,1283380,809187,755254,402483,352771,629,340,289,1174361,929337,245024,865799,308562,2499528,281501,267197,78566,547097,2904140,729283,7635,5875,2582,2805,91,21478,88.0,57.0
Uttar Pradesh,Allahabad,25.392038662316445,82.05172446982063,175,UTTAR PRADESH,Allahabad,5954391,3131807,2822584,3665727,2199340,1466387,1309851,687076,622775,7955,4270,3685,2111907,1426110,685797,1286732,825175,3842484,474283,541146,185877,910601,5102041,796756,13782,4377,4391,2247,305,30492,90.0,62.0
Uttar Pradesh,Ambedkar Nagar,26.39119025974028,82.68282142857147,178,UTTAR PRADESH,Ambedkar Nagar,2397888,1212410,1185478,1486939,846676,640263,591125,298240,292885,746,406,340,787398,547406,239992,440998,346400,1610490,213814,301120,58520,213944,1985654,401678,2536,869,1817,235,33,5066,98.0,62.0
Uttar Pradesh,Auraiya,26.66892394014961,79.42637057356607,162,UTTAR PRADESH,Auraiya,1379545,740040,639505,930836,546198,384638,391622,211413,180209,150,91,59,442023,364543,77480,325721,116302,937522,166731,151727,12533,111032,1273546,101963,1004,371,332,228,444,1657,86.0,67.0
Uttar Pradesh,Azamgarh,26.008290954773837,83.01220251256285,191,UTTAR PRADESH,Azamgarh,4613913,2285004,2328909,2771917,1559414,1212503,1171378,579586,591792,9327,4690,4637,1372032,941890,430142,784272,587760,3241881,425630,452055,115991,378356,3878626,718692,3810,719,5652,183,226,6005,102.0,60.0
Uttar Pradesh,Baghpat,29.045793499999988,77.30266300000001,139,UTTAR PRADESH,Baghpat,1303048,700070,602978,797970,489858,308112,149060,79920,69140,14,10,4,416695,342604,74091,334519,82176,886353,124718,74500,20347,197130,917474,364583,1840,483,161,16139,25,2343,86.0,61.0
Uttar Pradesh,Bahraich,27.691776300578027,81.46779783237004,180,UTTAR PRADESH,Bahraich,3487731,1843884,1643847,1398368,878285,520083,509307,270226,239081,11159,5606,5553,1152160,895576,256584,743452,408708,2335571,430227,482897,37965,201071,2291892,1169330,6400,8212,2793,1177,38,7889,89.0,40.0
Uttar Pradesh,Ballia,25.86075638297873,84.03651978723408,193,UTTAR PRADESH,Ballia,3239774,1672902,1566872,1963590,1160960,802630,494698,257624,237074,110114,56817,53297,1019483,723060,296423,569522,449961,2220291,206228,384432,72194,356629,3004240,213440,4463,892,1595,233,64,14847,94.0,61.0
Uttar Pradesh,Balrampur,27.449076537911324,82.47158326180256,182,UTTAR PRADESH,Balrampur,2148665,1114721,1033944,868357,544943,323414,277212,145928,131284,24887,12657,12230,760253,534332,225921,458727,301526,1388412,276614,328768,29916,124955,1333242,805975,3228,900,1866,198,87,3169,93.0,40.0
Uttar Pradesh,Banda,25.351885902503284,80.52487391304344,170,UTTAR PRADESH,Banda,1799410,965876,833534,1002937,630626,372311,387855,208184,179671,163,82,81,701689,485314,216375,483232,218457,1097721,251755,273458,19098,157378,1637549,157612,1367,231,168,916,50,1517,86.0,56.0
Uttar Pradesh,Bara Banki,26.922777025232424,81.35762350597606,176,UTTAR PRADESH,Bara Banki,3260699,1707073,1553626,1692458,1010518,681940,864559,453168,411391,610,333,277,1192850,871241,321609,834294,358556,2067849,458479,421973,77235,235163,2505444,737106,4857,2090,1553,3016,211,6422,91.0,52.0
Uttar Pradesh,Bareilly,28.51101940789474,79.43187072368416,150,UTTAR PRADESH,Bareilly,4448359,2357665,2090694,2191759,1342697,849062,557150,295964,261186,3227,1664,1563,1401971,1153006,248965,1043912,358059,3046388,365985,326376,131699,577911,2830768,1536534,14822,28187,4371,931,339,32407,89.0,49.0
Uttar Pradesh,Basti,26.833880454545447,82.69790590909092,185,UTTAR PRADESH,Basti,2464464,1255272,1209192,1393783,819719,574064,513959,262534,251425,3620,1876,1744,783688,558642,225046,443724,339964,1680776,296928,282260,36856,167644,2082976,364510,3493,900,9753,107,99,2626,96.0,57.0
Uttar Pradesh,Bijnor,29.313974259681096,78.45098815489754,134,UTTAR PRADESH,Bijnor,3682713,1921215,1761498,2135393,1241471,893922,787444,413872,373572,3058,1588,1470,1088036,921497,166539,839778,248258,2594677,232158,311489,52549,491840,2032081,1585210,6184,50624,1736,2134,41,4703,92.0,58.0
Uttar Pradesh,Bulandshahr,28.34875862068968,78.01082758620684,142,UTTAR PRADESH,Bulandshahr,3499171,1845260,1653911,2031656,1253314,778342,725600,384743,340857,198,118,80,1173260,897815,275445,885216,288044,2325911,332475,241137,65937,533711,2707195,777407,4088,2765,669,1572,86,5389,90.0,58.0
Uttar Pradesh,Chandauli,25.1180859611231,83.25307062634984,196,UTTAR PRADESH,Chandauli,1952756,1017905,934851,1174606,699454,475152,446786,235161,211625,41725,21571,20154,652543,462971,189572,341927,310616,1300213,125980,248674,58552,219337,1727869,215081,2153,1389,340,100,1175,4649,92.0,60.0
Uttar Pradesh,Chitrakoot,25.159924623803,81.07666087551297,171,UTTAR PRADESH,Chitrakoot,991730,527721,464009,531072,330339,200733,266655,141379,125276,366,196,170,394197,254977,139220,282614,111583,597533,160094,150695,12555,70853,955372,34559,693,63,101,285,27,630,88.0,54.0
Uttar Pradesh,Deoria,26.42218856548857,83.8244070686071,190,UTTAR PRADESH,Deoria,3100946,1537436,1563510,1875239,1079288,795951,468663,235694,232969,109894,54216,55678,876246,639073,237173,455382,420864,2224700,238237,291016,50418,296575,2730957,358539,3626,818,1182,209,146,5469,102.0,60.0
Uttar Pradesh,Etah,27.591155309734443,78.70021858407083,201,UTTAR PRADESH,Etah,1774480,947339,827141,1055202,647042,408160,281011,150631,130380,140,87,53,545984,440244,105740,415476,130508,1228496,242396,131779,28396,143413,1611126,146346,2464,708,2887,5671,18,5260,87.0,59.0
Uttar Pradesh,Etawah,26.78817670157068,79.07621806282728,161,UTTAR PRADESH,Etawah,1581810,845856,735954,1062003,623583,438420,388283,208731,179552,169,89,80,506072,413713,92359,361588,144484,1075738,170827,158026,20803,156416,1457892,113961,1362,1045,1733,3917,94,1806,87.0,67.0
Uttar Pradesh,Faizabad,26.60589185185181,82.00783530864202,177,UTTAR PRADESH,Faizabad,2470996,1259628,1211368,1450901,838339,612562,555047,281284,273763,931,469,462,831209,597888,233321,496579,334630,1639787,260406,272734,43505,254564,2094271,365806,3225,1912,737,358,185,4502,96.0,59.0
Uttar Pradesh,Farrukhabad,27.45063297872342,79.4406284574468,159,UTTAR PRADESH,Farrukhabad,1885204,1006240,878964,1092677,654827,437850,312712,168009,144703,230,124,106,592267,494545,97722,474686,117581,1292937,245089,135679,43528,167971,1596278,276846,3137,3160,3161,487,100,2035,87.0,58.0
Uttar Pradesh,Fatehpur,25.8374362030905,80.85416203090509,172,UTTAR PRADESH,Fatehpur,2632733,1384722,1248011,1512166,911003,601163,651480,342892,308588,340,189,151,1063929,713736,350193,670156,393773,1568804,328758,425366,51555,258250,2274674,350700,2201,402,172,199,47,4338,90.0,57.0
Uttar Pradesh,Firozabad,27.20963993055552,78.42660624999998,147,UTTAR PRADESH,Firozabad,2498156,1332046,1166110,1521806,912314,609492,473890,253288,220602,2565,1346,1219,761521,621840,139681,573649,187872,1736635,184595,150221,59942,366763,2140745,314812,3370,1804,3395,19077,61,14892,88.0,61.0
Uttar Pradesh,Gautam Buddha Nagar,28.393311038961038,77.52462467532465,141,UTTAR PRADESH,Gautam Buddha Nagar,1648115,890214,757901,1122947,666065,456882,216105,115438,100667,2215,1189,1026,569109,443384,125725,458492,110617,1079006,72668,48845,35400,412196,1394025,215500,7366,9261,895,4518,91,16459,85.0,68.0
Uttar Pradesh,Ghaziabad,28.74997308584685,77.67441879350343,140,UTTAR PRADESH,Ghaziabad,4681645,2488834,2192811,3123264,1811397,1311867,773463,412750,360713,3968,2104,1864,1520538,1231615,288923,1252911,267627,3161107,158868,123680,83672,1154318,3414427,1186776,19026,23001,3487,16412,265,18251,88.0,67.0
Uttar Pradesh,Ghazipur,25.624724775583484,83.5360854578097,195,UTTAR PRADESH,Ghazipur,3620268,1855075,1765193,2197549,1293553,903996,726641,375015,351626,28712,14664,14048,1204602,808700,395902,766881,437721,2415666,368943,435934,68254,331471,3233790,368153,4181,810,3145,213,184,9792,95.0,61.0
Uttar Pradesh,Gonda,27.157215552099505,82.0226888024882,183,UTTAR PRADESH,Gonda,3433919,1787146,1646773,1679994,1034181,645813,531973,276656,255317,870,476,394,1170552,855848,314704,739663,430889,2263367,440340,431532,65299,233381,2739076,678615,4735,1893,649,338,57,8556,92.0,49.0
Uttar Pradesh,Gorakhpur,26.63315886792452,83.3549560377358,188,UTTAR PRADESH,Gorakhpur,4440895,2277777,2163118,2700328,1593890,1106438,936061,481123,454938,18172,9261,8911,1351629,1016876,334753,746381,605248,3089266,255660,454931,82965,558073,4009037,403847,9662,2123,2848,460,207,12711,95.0,61.0
Uttar Pradesh,Hardoi,27.337409090909137,80.26411767676768,155,UTTAR PRADESH,Hardoi,4092845,2191442,1901403,2221601,1374587,847014,1274505,685223,589282,349,186,163,1318946,1091952,226994,969871,349075,2773899,596813,406830,59649,255654,3508131,556219,5822,5688,6671,446,98,9770,87.0,54.0
Uttar Pradesh,Jalaun,26.067954587155988,79.36686911314993,165,UTTAR PRADESH,Jalaun,1689974,906092,783882,1075196,653430,421766,468178,252588,215590,832,428,404,620764,470969,149795,420266,200498,1069210,196613,243035,26109,155007,1509708,171581,1148,463,2875,256,145,3798,87.0,64.0
Uttar Pradesh,Jaunpur,25.70141280913127,82.54315351934063,194,UTTAR PRADESH,Jaunpur,4494204,2220465,2273739,2731677,1565394,1166283,990345,494226,496119,4736,2363,2373,1437375,934157,503218,896547,540828,3056829,540762,436792,88404,371417,3981502,483750,4947,1286,7898,349,114,14358,102.0,61.0
Uttar Pradesh,Jhansi,25.45581535234902,78.89954580536917,166,UTTAR PRADESH,Jhansi,1998603,1057436,941167,1304513,783705,520808,562505,297386,265119,3873,2074,1799,814914,565357,249557,560041,254873,1183689,228881,248072,48648,289313,1823930,147842,7050,4951,1203,7328,311,5988,89.0,65.0
Uttar Pradesh,Jyotiba Phule Nagar,28.870498984771597,78.39009365482241,137,UTTAR PRADESH,Jyotiba Phule Nagar,1840221,963449,876772,983110,600541,382569,318001,166662,151339,164,89,75,599089,459037,140052,453567,145522,1241132,217672,131877,31600,217940,1075440,750368,5952,5295,189,517,21,2439,91.0,53.0
Uttar Pradesh,Kannauj,26.993988617886185,79.64437940379408,160,UTTAR PRADESH,Kannauj,1656616,881776,774840,1017087,603596,413491,309980,166454,143526,15,9,6,524676,430934,93742,419027,105649,1131940,239350,129517,51330,104479,1375788,273967,1263,504,2033,606,65,2390,88.0,61.0
Uttar Pradesh,Kanpur Dehat,26.43047641196011,79.98710083056478,163,UTTAR PRADESH,Kanpur Dehat,1796184,963255,832929,1170243,692964,477279,460544,248195,212349,801,398,403,628864,493991,134873,448651,180213,1167320,224986,234069,20783,149026,1612968,176327,1300,478,819,155,103,4034,86.0,65.0
Uttar Pradesh,Kaushambi,25.53587532051282,81.41811282051287,174,UTTAR PRADESH,Kaushambi,1599596,838485,761111,813424,507279,306145,555397,291303,264094,193,102,91,639086,402644,236442,415312,223774,960510,141102,321410,30491,146083,1372381,220423,2225,522,687,545,3,2810,91.0,51.0
Uttar Pradesh,Kushinagar,26.892530675909864,83.92261542461007,189,UTTAR PRADESH,Kushinagar,3564544,1818055,1746489,1954820,1183722,771098,544231,278947,265284,80269,41003,39266,1116973,804857,312116,523258,593715,2447571,265686,528388,57049,265850,2928462,620244,5006,767,4619,383,133,4930,96.0,55.0
Uttar Pradesh,Lalitpur,24.58877161016945,78.60082330508473,167,UTTAR PRADESH,Lalitpur,1221592,641011,580581,641191,397586,243605,240519,126325,114194,71610,36834,34776,503351,326783,176568,357033,146318,718241,267580,131354,14882,89535,1163804,33724,1351,1034,69,20390,41,1179,91.0,52.0
Uttar Pradesh,Lucknow,26.838233589251463,80.89706026871404,157,UTTAR PRADESH,Lucknow,4589838,2394476,2195362,3127260,1742440,1384820,948294,498799,449495,7506,4036,3470,1542806,1226399,316407,1152285,390521,3047032,175578,203029,99863,1064336,3537787,985070,20493,23883,3877,4975,504,13249,92.0,68.0
Uttar Pradesh,Mahoba,25.34529670138888,79.67863003472216,169,UTTAR PRADESH,Mahoba,875958,466358,409600,488106,302283,185823,220898,117389,103509,647,355,292,349676,237153,112523,238712,110964,526282,114244,130422,13523,91487,815142,57454,965,389,94,234,157,1523,88.0,56.0
Uttar Pradesh,Mainpuri,27.17386862302482,79.03501851015807,148,UTTAR PRADESH,Mainpuri,1868529,993377,875152,1203885,712110,491775,368206,196507,171699,478,258,220,560840,466067,94773,424782,136058,1307689,270888,137174,24784,127994,1746649,100723,1729,475,8814,4161,38,5940,88.0,64.0
Uttar Pradesh,Mathura,27.59390432801821,77.62153416856502,145,UTTAR PRADESH,Mathura,2547184,1367125,1180059,1507746,943346,564400,506580,271295,235285,1520,826,694,840939,635142,205797,594799,246140,1706245,235886,179248,44453,381352,2310776,216933,3179,2872,883,2056,126,10359,86.0,59.0
Uttar Pradesh,Mau,26.01082203791469,83.50582654028433,192,UTTAR PRADESH,Mau,2205968,1114709,1091259,1363044,773082,589962,474537,241498,233039,22915,11464,11451,696747,475413,221334,396438,300309,1509221,145225,212343,118614,220565,1769937,428555,2109,340,564,155,129,4179,98.0,62.0
Uttar Pradesh,Meerut,29.02957625698323,77.80611005586593,138,UTTAR PRADESH,Meerut,3443689,1825743,1617946,2141488,1254520,886968,624149,334198,289951,3390,1828,1562,1090539,898810,191729,890810,199729,2353150,196068,153995,63096,677380,2183255,1185643,10582,24912,1855,18544,236,18662,89.0,62.0
Uttar Pradesh,Mirzapur,25.10207959183675,82.60126628571429,199,UTTAR PRADESH,Mirzapur,2496970,1312302,1184668,1428683,865837,562846,661129,347436,313693,20132,10480,9652,881996,613061,268935,537091,344905,1614974,178132,334372,80246,289246,2292534,195765,2373,1133,341,701,27,4096,90.0,57.0
Uttar Pradesh,Moradabad,28.851770406189537,78.73580193423597,135,UTTAR PRADESH,Moradabad,4772006,2503186,2268820,2263848,1357435,906413,731406,385244,346162,685,377,308,1417811,1193439,224372,1104968,312843,3354195,368638,338384,88733,622056,2488265,2248392,13157,7555,1260,2426,382,10569,91.0,47.0
Uttar Pradesh,Muzaffarnagar,29.470507977736563,77.64017847866423,133,UTTAR PRADESH,Muzaffarnagar,4143512,2193434,1950078,2417339,1448528,968811,561250,298587,262663,317,176,141,1291644,1081569,210075,1085491,206153,2851868,336049,323641,45952,586002,2382914,1711453,6495,18601,1516,16345,60,6128,89.0,58.0
Uttar Pradesh,Pilibhit,28.52024175035868,79.90103974175037,151,UTTAR PRADESH,Pilibhit,2031007,1072002,959005,1061095,654290,406805,333558,176436,157122,1714,892,822,618605,534939,83666,463415,155190,1412402,216476,224192,22782,155155,1449007,489686,3510,84787,360,138,45,3474,89.0,52.0
Uttar Pradesh,Pratapgarh,25.864842731707316,81.93530048780492,131,RAJASTHAN,Pratapgarh,867848,437744,430104,401515,250122,151393,60429,30755,29674,550427,276742,273685,481294,251691,229603,327445,153849,386554,306419,96815,5516,72544,827293,25597,358,72,32,14077,27,392,98.0,46.0
Uttar Pradesh,Pratapgarh,25.864842731707316,81.93530048780492,173,UTTAR PRADESH,Pratapgarh,3209141,1606085,1603056,1931559,1121381,810178,709252,351054,358198,723,380,343,1066601,704569,362032,553013,513588,2142540,305746,386563,68642,305650,2731351,452394,3920,1451,7795,746,43,11441,100.0,60.0
Uttar Pradesh,Rae Bareli,26.253902840059787,81.22260463378181,158,UTTAR PRADESH,Rae Bareli,3405559,1752542,1653017,1965843,1165965,799878,1030367,526735,503632,1756,876,880,1204710,867393,337317,644869,559841,2200849,316891,507882,60774,319163,2975998,413243,3634,2424,722,397,602,8539,94.0,58.0
Uttar Pradesh,Rampur,28.83244727272725,79.10977333333337,136,UTTAR PRADESH,Rampur,2335819,1223889,1111930,1043666,630408,413258,307936,162844,145092,358,207,151,737261,609693,127568,564266,172995,1598558,214187,230238,54238,238598,1073890,1181337,9201,65316,384,1307,63,4321,91.0,45.0
Uttar Pradesh,Saharanpur,30.03381165217392,77.59905147826095,132,UTTAR PRADESH,Saharanpur,3466382,1834106,1632276,2077108,1220114,856994,764450,407029,357421,980,517,463,1037344,911136,126208,882701,154643,2429038,221567,273050,34032,508695,1966892,1454052,6523,18627,1937,10208,135,8008,89.0,60.0
Uttar Pradesh,Sant Kabir Nagar,26.791596516393444,83.0387764344262,186,UTTAR PRADESH,Sant Kabir Nagar,1715183,869656,845527,954949,567098,387851,369039,187413,181626,1593,823,770,539469,383482,155987,265453,274016,1175714,149604,241825,28884,119156,1300586,404410,1766,447,4393,95,35,3451,97.0,56.0
Uttar Pradesh,Shahjahanpur,27.991389350649328,79.8302275324675,152,UTTAR PRADESH,Shahjahanpur,3006538,1606403,1400135,1490930,915142,575788,532673,285280,247393,508,259,249,892214,783313,108901,699503,192711,2114324,344973,275192,31141,240908,2412595,527581,4630,51090,2312,301,84,7945,87.0,50.0
Uttar Pradesh,Sitapur,27.501995963091108,80.85288881199547,154,UTTAR PRADESH,Sitapur,4483992,2375264,2108728,2283733,1397702,886031,1446427,767033,679394,1602,833,769,1422602,1171252,251350,1023642,398960,3061390,571097,473554,70971,306980,3555450,893725,6579,11611,2663,1410,79,12475,89.0,51.0
Uttar Pradesh,Sonbhadra,24.46693268858798,83.06816324951639,200,UTTAR PRADESH,Sonbhadra,1862559,971344,891215,985708,601988,383720,421661,218996,202665,385018,197825,187193,730399,463611,266788,397196,333203,1132160,141007,371261,29417,188714,1738769,103567,3963,1649,1747,487,1907,10470,92.0,53.0
Uttar Pradesh,Sultanpur,26.2846386419753,82.05710456790123,179,UTTAR PRADESH,Sultanpur,3797117,1914586,1882531,2239902,1300248,939654,851587,431438,420149,696,358,338,1242632,869838,372794,690967,551665,2554485,338890,501634,85785,316323,3119590,650261,4453,1629,9989,426,336,10433,98.0,59.0
Uttar Pradesh,Unnao,26.63163990895297,80.636773292868,156,UTTAR PRADESH,Unnao,3108367,1630087,1478280,1773584,1053063,720521,948588,494487,454101,2926,1558,1368,1124744,851014,273730,761831,362913,1983623,450123,332663,49243,292715,2732016,363453,3574,1204,920,240,31,6929,91.0,57.0
Uttar Pradesh,Varanasi,25.36057088888889,82.82529666666672,197,UTTAR PRADESH,Varanasi,3676841,1921857,1754984,2403903,1389116,1014787,486958,256483,230475,28617,14992,13625,1220708,921234,299474,920761,299947,2456133,197952,182146,168764,671846,3107681,546987,7696,3309,1146,1898,298,7826,91.0,65.0
Uttaranchal,Almora,29.683532133676103,79.50165064267351,64,UTTARAKHAND,Almora,622506,291081,331425,436497,231604,204893,150995,72695,78300,1281,633,648,298211,142460,155751,201078,97133,324295,207617,10274,4312,76008,611250,7752,1895,256,201,31,6,1115,114.0,70.0
Uttaranchal,Bageshwar,29.98703393393397,79.83954354354357,63,UTTARAKHAND,Bageshwar,259898,124326,135572,179483,97546,81937,72061,35623,36438,1982,971,1011,123638,58708,64930,78085,45553,136260,85125,8985,2991,26537,257509,1440,397,46,102,7,16,381,109.0,69.0
Uttaranchal,Chamoli,30.58338611464965,79.56281095541402,57,UTTARAKHAND,Chamoli,391605,193991,197614,280556,155395,125161,79317,39718,39599,12260,6021,6239,180940,93832,87108,115115,65825,210665,121157,3845,5384,50554,385818,4395,428,323,190,11,23,417,102.0,72.0
Uttaranchal,Champawat,29.29142393939393,80.07720212121217,65,UTTARAKHAND,Champawat,259648,131125,128523,177726,102015,75711,47383,24188,23195,1339,777,562,99566,60427,39139,62698,36868,160082,59993,4032,1570,33971,249563,8693,870,336,24,28,6,128,98.0,68.0
Uttaranchal,Pithoragarh,30.14720631868129,80.34229230769236,62,UTTARAKHAND,Pithoragarh,483439,239306,244133,345550,189623,155927,120378,60111,60267,19535,9558,9977,216490,113539,102951,145481,71009,266949,137332,5432,6055,67671,475105,6015,1401,260,185,13,30,430,102.0,71.0
Uttaranchal,Tehri Garhwal,30.463700918635173,78.48783792650917,59,UTTARAKHAND,Tehri Garhwal,618931,297986,320945,407994,227406,180588,102130,50371,51759,875,459,416,280442,140821,139621,165912,114530,338489,187121,8129,4021,81171,609835,7374,656,290,32,91,109,544,108.0,66.0
Uttaranchal,Udham Singh Nagar,29.02779577677222,79.45629004524895,67,UTTARAKHAND,Udham Singh Nagar,1648902,858783,790119,1037839,598525,439314,238264,124385,113879,123037,61758,61279,591458,444578,146880,450762,140696,1057444,122686,165250,26396,277126,1104452,372267,6064,162768,505,738,159,1949,92.0,63.0
Uttaranchal,Uttarkashi,30.968958552036234,78.56880615384617,56,UTTARAKHAND,Uttarkashi,330086,168597,161489,215126,128237,86889,80567,40833,39734,3512,1651,1861,157276,84265,73011,128367,28909,172810,117264,4387,3122,32503,324859,3554,353,167,563,74,105,411,96.0,65.0
West Bengal,Bankura,23.081280892857155,87.12640053571437,339,WEST BENGAL,Bankura,3596674,1838095,1758579,2232992,1299337,933655,1174447,593440,581007,368690,183467,185223,1466220,1050822,415398,916393,549827,2130454,309723,647374,61386,447737,3033581,290450,3865,386,260,2904,260694,4534,96.0,62.0
West Bengal,Barddhaman,23.444453888888884,87.8150581111111,335,WEST BENGAL,Barddhaman,7717563,3966889,3750674,5247208,2918040,2329168,2115719,1079584,1036135,489447,243581,245866,2911251,2293083,618168,2166742,744509,4806312,342166,973182,124558,1471345,6008472,1599764,21220,16675,1602,1674,44968,23188,95.0,68.0
West Bengal,Birbhum,24.06389342723,87.65153089201888,334,WEST BENGAL,Birbhum,3502404,1790920,1711484,2158447,1201481,956966,1033140,529001,504139,242484,119787,122697,1331603,1029770,301833,912844,418759,2170801,227254,611510,65062,427777,2181515,1298054,10906,582,258,1152,6051,3886,96.0,62.0
West Bengal,Dakshin Dinajpur,25.342094363021435,88.69821679819614,331,WEST BENGAL,Dakshin Dinajpur,1676276,857199,819077,1083685,596474,487211,482754,248312,234442,275366,138025,137341,702987,499560,203427,526470,176517,973289,193276,279932,32290,197489,1232850,412788,24794,276,148,323,2786,2311,96.0,65.0
West Bengal,Darjiling,26.839619571045585,88.33145067024122,327,WEST BENGAL,Darjiling,1846823,937259,909564,1315585,717673,597912,317275,161495,155780,397389,197251,200138,683726,479586,204140,532855,150871,1163097,76178,66041,16579,524928,1366681,105086,141848,2032,209240,1840,15523,4573,97.0,71.0
West Bengal,Haora,22.401674174428507,87.99421176968654,341,WEST BENGAL,Haora,4850029,2500819,2349210,3605206,1942824,1662382,718951,367053,351898,15094,7761,7333,1819845,1498170,321675,1496267,323578,3030184,80575,181662,297774,1259834,3535844,1270641,8666,4380,1258,9699,1265,18276,94.0,74.0
West Bengal,Hugli,22.87929264705881,88.00010264705891,338,WEST BENGAL,Hugli,5519145,2814653,2704492,4078388,2211777,1866611,1344021,680992,663029,229243,113249,115994,2152870,1713608,439262,1714645,438225,3366275,259680,583380,111828,1197982,4574569,870204,7300,2662,1730,2160,49050,11470,96.0,74.0
West Bengal,Jalpaiguri,26.62642031250004,89.04154375000003,328,WEST BENGAL,Jalpaiguri,3872846,1983064,1889782,2498780,1396622,1102158,1458278,750841,707437,731704,365868,365836,1512910,1091361,421549,1153765,359145,2359936,214932,349672,30090,918216,3156781,445817,186279,2994,50676,1461,23816,5022,95.0,65.0
West Bengal,Kolkata,22.550581481481483,88.3527648148148,342,WEST BENGAL,Kolkata,4496694,2356766,2139928,3588137,1926915,1661222,241932,128053,113879,10684,5729,4955,1795740,1412466,383274,1576419,219321,2700954,16039,12388,68438,1698875,3440290,926414,39758,13849,4771,21178,1452,48982,91.0,80.0
West Bengal,Maldah,25.08026802575105,88.17191684549356,332,WEST BENGAL,Maldah,3988845,2051541,1937304,2086432,1152019,934413,835430,432744,402686,313984,157528,156456,1537847,1086461,451386,1050995,486852,2450998,255182,545759,196687,540219,1914352,2045151,13209,747,359,639,7929,6459,94.0,52.0
West Bengal,Murshidabad,24.25950655391121,88.16816860465121,333,WEST BENGAL,Murshidabad,7103807,3627564,3476243,4055834,2177187,1878647,897534,460143,437391,91035,46163,44872,2589907,1985667,604240,2022083,567824,4513900,381076,842294,466007,900530,2359061,4707573,18102,766,348,3037,7429,7491,96.0,57.0
West Bengal,Nadia,23.56410971055088,88.58293034547152,336,WEST BENGAL,Nadia,5167600,2653768,2513832,3480555,1878866,1601689,1546917,798258,748659,140700,71142,69558,1842607,1554090,288517,1595880,246727,3324993,308742,556134,169138,808593,3728482,1382682,33835,849,514,281,16893,4064,95.0,67.0
West Bengal,Puruliya,23.254192328767108,86.3968532876713,340,WEST BENGAL,Puruliya,2930115,1496996,1433119,1624905,1002058,622847,567767,290789,276978,540652,271803,268849,1249642,801254,448388,613398,636244,1680473,268800,492205,87560,401077,2373120,227249,8646,622,209,3052,309029,8188,96.0,55.0
West Bengal,Uttar Dinajpur,26.044619165196977,88.23595232216337,330,WEST BENGAL,Uttar Dinajpur,3007134,1551066,1456068,1489667,853495,636172,807950,418288,389662,162816,81831,80985,1075626,799627,275999,824342,251284,1931508,257377,442328,37978,337943,1482943,1501170,16702,477,432,1324,1622,2464,94.0,50.0
